Rank,Release Group,Worldwide,Domestic,Foreign,filename,year,Domestic %,Foreign %
1,Avengers: Endgame,2797800564,858373000,1939427564,2019.csv,2019,30.7%,69.3%
2,Avengers: Infinity War,2048359754,678815482,1369544272,2018.csv,2018,33.1%,66.9%
3,The Lion King,1656943394,543638043,1113305351,2019.csv,2019,32.8%,67.2%
4,Frozen II,1450026933,477373578,972653355,2019.csv,2019,32.9%,67.1%
5,Black Panther,1346913161,700059566,646853595,2018.csv,2018,52%,48%
6,Jurassic World: Fallen Kingdom,1308467944,417719760,890748184,2018.csv,2018,31.9%,68.1%
7,Incredibles 2,1242805359,608581744,634223615,2018.csv,2018,49%,51%
8,Aquaman,1148461807,335061807,813400000,2018.csv,2018,29.2%,70.8%
9,Spider-Man: Far from Home,1131927996,390532085,741395911,2019.csv,2019,34.5%,65.5%
10,Captain Marvel,1128274794,426829839,701444955,2019.csv,2019,37.8%,62.2%
11,Joker,1074251311,335451311,738800000,2019.csv,2019,31.2%,68.8%
12,Star Wars: Episode IX - The Rise of Skywalker,1074144248,515202542,558941706,2019.csv,2019,48%,52%
13,Toy Story 4,1073394593,434038008,639356585,2019.csv,2019,40.4%,59.6%
14,Aladdin,1050693953,355559216,695134737,2019.csv,2019,33.8%,66.2%
15,Bohemian Rhapsody,903655259,216428042,687227217,2018.csv,2018,24%,76%
16,Venom,856085151,213515506,642569645,2018.csv,2018,24.9%,75.1%
17,Jumanji: The Next Level,796575993,316831246,479744747,2019.csv,2019,39.8%,60.2%
18,Mission: Impossible - Fallout,791115104,220159104,570956000,2018.csv,2018,27.8%,72.2%
19,Fast & Furious Presents: Hobbs & Shaw,759056935,173956935,585100000,2019.csv,2019,22.9%,77.1%
20,Deadpool 2,734546611,318491426,416055185,2018.csv,2018,43.4%,56.6%
21,Ne Zha,726063471,3695533,722367938,2019.csv,2019,0.5%,99.5%
22,The Wandering Earth,699760773,5875487,693885286,2019.csv,2019,0.8%,99.2%
23,Fantastic Beasts: The Crimes of Grindelwald,654855901,159555901,495300000,2018.csv,2018,24.4%,75.6%
24,Ant-Man and the Wasp,622674139,216648740,406025399,2018.csv,2018,34.8%,65.2%
25,Ready Player One,582890172,137690172,445200000,2018.csv,2018,23.6%,76.4%
26,Operation Red Sea,579330426,1543547,577786879,2018.csv,2018,0.3%,99.7%
27,Detective Chinatown 2,544185156,1983984,542201172,2018.csv,2018,0.4%,99.6%
28,The Meg,530243742,145443742,384800000,2018.csv,2018,27.4%,72.6%
29,Ralph Breaks the Internet,529323962,201091711,328232251,2018.csv,2018,38%,62%
30,Hotel Transylvania 3: Summer Vacation,528583774,167510016,361073758,2018.csv,2018,31.7%,68.3%
31,How to Train Your Dragon: The Hidden World,521799505,160799505,361000000,2019.csv,2019,30.8%,69.2%
32,Dr. Seuss' The Grinch,511595957,270620950,240975007,2018.csv,2018,52.9%,47.1%
33,Maleficent: Mistress of Evil,491730089,113929605,377800484,2019.csv,2019,23.2%,76.8%
34,It Chapter Two,473093228,211593228,261500000,2019.csv,2019,44.7%,55.3%
35,Bumblebee,467989645,127195589,340794056,2018.csv,2018,27.2%,72.8%
36,"My People, My Country",450064993,2356683,447708310,2019.csv,2019,0.5%,99.5%
37,A Star Is Born,436188866,215288866,220900000,2018.csv,2018,49.4%,50.6%
38,Pok√©mon Detective Pikachu,433005346,144105346,288900000,2019.csv,2019,33.3%,66.7%
39,The Secret Life of Pets 2,430051293,158874395,271176898,2019.csv,2019,36.9%,63.1%
40,Rampage,428028233,101028233,327000000,2018.csv,2018,23.6%,76.4%
41,Bad Boys for Life,425514702,204417855,221096847,2020.csv,2020,48%,52%
42,The Captain,416953262,706572,416246690,2019.csv,2019,0.2%,99.8%
43,Alita: Battle Angel,404852543,85710210,319142333,2019.csv,2019,21.2%,78.8%
44,Mamma Mia! Here We Go Again,395044706,120634935,274409771,2018.csv,2018,30.5%,69.5%
45,Solo: A Star Wars Story,392924807,213767512,179157295,2018.csv,2018,54.4%,45.6%
46,Godzilla: King of the Monsters,386600138,110500138,276100000,2019.csv,2019,28.6%,71.4%
47,Spider-Man: Into the Spider-Verse,375540831,190241310,185299521,2018.csv,2018,50.7%,49.3%
48,Once Upon a Time... in Hollywood,374343626,142502728,231840898,2019.csv,2019,38.1%,61.9%
49,Fifty Shades Freed,371985018,100407760,271577258,2018.csv,2018,27%,73%
50,1917,368027644,159227644,208800000,2019.csv,2019,43.3%,56.7%
51,Shazam!,365971656,140371656,225600000,2019.csv,2019,38.4%,61.6%
52,The Nun,365550119,117450119,248100000,2018.csv,2018,32.1%,67.9%
53,Monster Hunt 2,361682618,706153,360976465,2018.csv,2018,0.2%,99.8%
54,Dumbo,353284621,114766307,238518314,2019.csv,2019,32.5%,67.5%
55,Peter Rabbit,351266433,115253424,236013009,2018.csv,2018,32.8%,67.2%
56,Mary Poppins Returns,349537494,171958438,177579056,2018.csv,2018,49.2%,50.8%
57,A Quiet Place,340939361,188024361,152915000,2018.csv,2018,55.1%,44.9%
58,Green Book,326750920,85080171,241670749,2018.csv,2018,26%,74%
59,John Wick: Chapter 3 - Parabellum,326709727,171015687,155694040,2019.csv,2019,52.3%,47.7%
60,Knives Out,311553190,165363234,146189956,2019.csv,2019,53.1%,46.9%
61,Sonic the Hedgehog,306766470,146066470,160700000,2020.csv,2020,47.6%,52.4%
62,Skyscraper,304868961,68420120,236448841,2018.csv,2018,22.4%,77.6%
63,Ocean's Eight,297718711,140218711,157500000,2018.csv,2018,47.1%,52.9%
64,Pacific Rim: Uprising,290930148,59874525,231055623,2018.csv,2018,20.6%,79.4%
65,Maze Runner: The Death Cure,288175335,58032443,230142892,2018.csv,2018,20.1%,79.9%
66,Tomb Raider,274650803,58250803,216400000,2018.csv,2018,21.2%,78.8%
67,Terminator: Dark Fate,261119292,62253077,198866215,2019.csv,2019,23.8%,76.2%
68,Halloween,255485178,159342015,96143163,2018.csv,2018,62.4%,37.6%
69,Us,255184580,175084580,80100000,2019.csv,2019,68.6%,31.4%
70,Parasite,254255151,53369749,200885402,2019.csv,2019,21%,79%
71,Men in Black: International,253890701,80001807,173888894,2019.csv,2019,31.5%,68.5%
72,X-Men: Dark Phoenix,252442974,65845974,186597000,2019.csv,2019,26.1%,73.9%
73,Glass,246999039,111048468,135950571,2019.csv,2019,45%,55%
74,The Bravest,245179562,290217,244889345,2019.csv,2019,0.1%,99.9%
75,Crazy Rich Asians,238532921,174532921,64000000,2018.csv,2018,73.2%,26.8%
76,Annabelle Comes Home,231252591,74152591,157100000,2019.csv,2019,32.1%,67.9%
77,Dolittle,227908130,77047065,150861065,2020.csv,2020,33.8%,66.2%
78,Ford v Ferrari,225508210,117624357,107883853,2019.csv,2019,52.2%,47.8%
79,Better Days,225320294,1921657,223398637,2019.csv,2019,0.9%,99.1%
80,Creed II,214215889,115715889,98500000,2018.csv,2018,54%,46%
81,Smallfoot,214040103,83240103,130800000,2018.csv,2018,38.9%,61.1%
82,Little Women,206006503,108101214,97905289,2019.csv,2019,52.5%,47.5%
83,The Addams Family,203044905,100044905,103000000,2019.csv,2019,49.3%,50.7%
84,Birds of Prey: And the Fantabulous Emancipation of One Harley Quinn,201858461,84158461,117700000,2020.csv,2020,41.7%,58.3%
85,The Island,198326350,670883,197655467,2018.csv,2018,0.3%,99.7%
86,Christopher Robin,197744377,99215042,98529335,2018.csv,2018,50.2%,49.8%
87,Rocketman,195179299,96368160,98811139,2019.csv,2019,49.4%,50.6%
88,The Lego Movie 2: The Second Part,192306508,105806508,86500000,2019.csv,2019,55%,45%
89,Downton Abbey,192094429,96854135,95240294,2019.csv,2019,50.4%,49.6%
90,The Equalizer 2,190400157,102084362,88315795,2018.csv,2018,53.6%,46.4%
91,Abominable,189892513,60716390,129176123,2019.csv,2019,32%,68%
92,The White Storm 2: Drug Lords,189396380,609461,188786919,2019.csv,2019,0.3%,99.7%
93,Weathering with You,186921054,7798743,179122311,2019.csv,2019,4.2%,95.8%
94,The Mule,174804407,103804407,71000000,2018.csv,2018,59.4%,40.6%
95,The Nutcracker and the Four Realms,173961069,54858851,119102218,2018.csv,2018,31.5%,68.5%
96,Gemini Man,173469516,48546770,124922746,2019.csv,2019,28%,72%
97,Spies in Disguise,171616764,66757013,104859751,2019.csv,2019,38.9%,61.1%
98,Insidious: The Last Key,167885588,67745330,100140258,2018.csv,2018,40.4%,59.6%
99,The Predator,160542134,51024708,109517426,2018.csv,2018,31.8%,68.2%
100,Johnny English Strikes Again,158970776,4412170,154558606,2018.csv,2018,2.8%,97.2%
101,Hustlers,157563598,104963598,52600000,2019.csv,2019,66.6%,33.4%
102,The Climbers,156759167,487157,156272010,2019.csv,2019,0.3%,99.7%
103,Escape Room,155712077,57005601,98706476,2019.csv,2019,36.6%,63.4%
104,The Angry Birds Movie 2,154692886,41667116,113025770,2019.csv,2019,26.9%,73.1%
105,Yesterday,153712841,73286650,80426191,2019.csv,2019,47.7%,52.3%
106,Red Sparrow,151572634,46874505,104698129,2018.csv,2018,30.9%,69.1%
107,Angel Has Fallen,147501990,69030436,78471554,2019.csv,2019,46.8%,53.2%
108,More Than Blue,142958164,722669,142235495,2018.csv,2018,0.5%,99.5%
109,The First Purge,137056262,69488745,67567517,2018.csv,2018,50.7%,49.3%
110,How Long Will I Love U,136796719,746933,136049786,2018.csv,2018,0.5%,99.5%
111,Ad Astra,132807427,50188370,82619057,2019.csv,2019,37.8%,62.2%
112,A Wrinkle in Time,132675864,100478608,32197256,2018.csv,2018,75.7%,24.3%
113,The House with a Clock in Its Walls,131457147,68549695,62907452,2018.csv,2018,52.1%,47.9%
114,The Upside,125852517,108252517,17600000,2019.csv,2019,86%,14%
115,Midway,125675266,56846802,68828464,2019.csv,2019,45.2%,54.8%
116,The Invisible Man,124549496,64914050,59635446,2020.csv,2020,52.1%,47.9%
117,The Curse of la Llorona,123133739,54733739,68400000,2019.csv,2019,44.5%,55.5%
118,Looking Up,122994583,84267,122910316,2019.csv,2019,<0.1%,99.9%
119,Zombieland: Double Tap,122810399,73123082,49687317,2019.csv,2019,59.5%,40.5%
120,Extreme Job,121978657,1565885,120412772,2019.csv,2019,1.3%,98.7%
121,Last Christmas,121550750,35150750,86400000,2019.csv,2019,28.9%,71.1%
122,Dora and the Lost City of Gold,120624994,60477943,60147051,2019.csv,2019,50.1%,49.9%
123,Instant Family,120556201,67363237,53192964,2018.csv,2018,55.9%,44.1%
124,Wonder Park,119559110,45216793,74342317,2019.csv,2019,37.8%,62.2%
125,A Cool Fish,118153135,551876,117601259,2018.csv,2018,0.5%,99.5%
126,P Storm,117991727,326711,117665016,2019.csv,2019,0.3%,99.7%
127,The Gentlemen,117769345,36296853,81472492,2020.csv,2020,30.8%,69.2%
128,Game Night,117679066,69179066,48500000,2018.csv,2018,58.8%,41.2%
129,Dragon Ball Super: Broly,115560610,30712119,84848491,2018.csv,2018,26.6%,73.4%
130,The Monkey King 3,115084576,187074,114897502,2018.csv,2018,0.2%,99.8%
131,Pet Sematary,113118226,54724696,58393530,2019.csv,2019,48.4%,51.6%
132,Good Boys,110940306,83140306,27800000,2019.csv,2019,74.9%,25.1%
133,The Call of the Wild,107604626,62342368,45262258,2020.csv,2020,57.9%,42.1%
134,First Man,105697415,44936545,60760870,2018.csv,2018,42.5%,57.5%
135,Scary Stories to Tell in the Dark,105647580,68947075,36700505,2019.csv,2019,65.3%,34.7%
136,Book Club,104438188,68566296,35871892,2018.csv,2018,65.7%,34.3%
137,Night School,103105878,77339130,25766748,2018.csv,2018,75%,25%
138,Line Walker 2: Invisible Spy,99482027,296751,99185276,2019.csv,2019,0.3%,99.7%
139,Alpha,98203196,35857181,62346015,2018.csv,2018,36.5%,63.5%
140,Along With the Gods: The Last 49 Days,97962238,1200246,96761992,2018.csv,2018,1.2%,98.8%
141,A Simple Favor,97644617,53548586,44096031,2018.csv,2018,54.8%,45.2%
142,The Favourite,95918706,34366783,61551923,2018.csv,2018,35.8%,64.2%
143,Blumhouse's Truth or Dare,95330493,41411015,53919478,2018.csv,2018,43.4%,56.6%
144,The Hustle,95017038,35417038,59600000,2019.csv,2019,37.3%,62.7%
145,I Feel Pretty,94539426,48795601,45743825,2018.csv,2018,51.6%,48.4%
146,Blockers,94017294,60311495,33705799,2018.csv,2018,64.1%,35.9%
147,BlacKkKlansman,93400823,49275340,44125483,2018.csv,2018,52.8%,47.2%
148,Goosebumps 2: Haunted Halloween,93320380,46700633,46619747,2018.csv,2018,50%,50%
149,Shadow,91708374,521396,91186978,2018.csv,2018,0.6%,99.4%
150,Crawl,91542097,39014193,52527904,2019.csv,2019,42.6%,57.4%
151,Five Feet Apart,91522094,45729221,45792873,2019.csv,2019,50%,50%
152,Rambo: Last Blood,91490353,44819352,46671001,2019.csv,2019,49%,51%
153,Overboard,91244913,50316123,40928790,2018.csv,2018,55.1%,44.9%
154,Sherlock Gnomes,90497778,43242871,47254907,2018.csv,2018,47.8%,52.2%
155,Jojo Rabbit,90335025,33370906,56964119,2019.csv,2019,36.9%,63.1%
156,Detective Dee: The Four Heavenly Kings,90040771,262963,89777808,2018.csv,2018,0.3%,99.7%
157,Robin Hood,86489031,30824628,55664403,2018.csv,2018,35.6%,64.4%
158,I Can Only Imagine,86026201,83482352,2543849,2018.csv,2018,97%,3%
159,Mortal Engines,83672673,15951040,67721633,2018.csv,2018,19.1%,80.9%
160,One Piece: Stampede,81562741,1298528,80264213,2019.csv,2019,1.6%,98.4%
161,A Dog's Way Home,80708134,42004346,38703788,2019.csv,2019,52%,48%
162,Den of Thieves,80509622,44947622,35562000,2018.csv,2018,55.8%,44.2%
163,Hereditary,80239658,44069456,36170202,2018.csv,2018,54.9%,45.1%
164,Tag,78130625,54730625,23400000,2018.csv,2018,70.1%,29.9%
165,Sanju,76693052,7909317,68783735,2018.csv,2018,10.3%,89.7%
166,Cold Pursuit,76419755,32138862,44280893,2019.csv,2019,42.1%,57.9%
167,Vice,76073488,47836282,28237206,2018.csv,2018,62.9%,37.1%
168,Widows,75984700,42402632,33582068,2018.csv,2018,55.8%,44.2%
169,Sicario: Day of the Soldado,75837743,50072235,25765508,2018.csv,2018,66%,34%
170,A Dog's Journey,75602573,22782371,52820202,2019.csv,2019,30.1%,69.9%
171,Searching,75462037,26020957,49441080,2018.csv,2018,34.5%,65.5%
172,The Spy Who Dumped Me,75320680,33562069,41758611,2018.csv,2018,44.6%,55.4%
173,A Madea Family Funeral,74747725,73257045,1490680,2019.csv,2019,98%,2%
174,Cats,73695985,27166770,46529215,2019.csv,2019,36.9%,63.1%
175,Charlie's Angels,73279888,17803077,55476811,2019.csv,2019,24.3%,75.7%
176,Doctor Sleep,72381712,31581712,40800000,2019.csv,2019,43.6%,56.4%
177,Second Act,72282227,39282227,33000000,2018.csv,2018,54.3%,45.7%
178,What Men Want,72216294,54611903,17604391,2019.csv,2019,75.6%,24.4%
179,Spirited Away 2018 Re-release,70186029,1175067,69010962,2018.csv,2018,1.7%,98.3%
180,After,69733482,12138565,57594917,2019.csv,2019,17.4%,82.6%
181,Exit,69501772,470699,69031073,2019.csv,2019,0.7%,99.3%
182,Playing with Fire,68631669,44451847,24179822,2019.csv,2019,64.8%,35.2%
183,Shoplifters,67998954,3313513,64685441,2018.csv,2018,4.9%,95.1%
184,A Beautiful Day in the Neighborhood,67760877,61704055,6056822,2019.csv,2019,91.1%,8.9%
185,12 Strong,67450815,45819713,21631102,2018.csv,2018,67.9%,32.1%
186,War,67179155,4654000,62525155,2019.csv,2019,6.9%,93.1%
187,"Love, Simon",66316289,40826341,25489948,2018.csv,2018,61.6%,38.4%
188,Mile 22,66308758,36108758,30200000,2018.csv,2018,54.5%,45.5%
189,Life of the Party,65859911,53059911,12800000,2018.csv,2018,80.6%,19.4%
190,Happy Death Day 2U,64600152,28148130,36452022,2019.csv,2019,43.6%,56.4%
191,Capernaum,64413178,1661096,62752082,2018.csv,2018,2.6%,97.4%
192,Isle of Dogs,64241499,32015231,32226268,2018.csv,2018,49.8%,50.2%
193,White Snake,61631776,34730,61597046,2019.csv,2019,<0.1%,99.9%
194,Ma,61105672,45896028,15209644,2019.csv,2019,75.1%,24.9%
195,Adrift,59945012,31445012,28500000,2018.csv,2018,52.5%,47.5%
196,Bombshell,59588732,31762808,27825924,2019.csv,2019,53.3%,46.7%
197,Ready or Not,57615777,28714231,28901546,2019.csv,2019,49.8%,50.2%
198,The 15:17 to Paris,57076286,36276286,20800000,2018.csv,2018,63.6%,36.4%
199,Early Man,54622814,8267544,46355270,2018.csv,2018,15.1%,84.9%
200,Peppermint,53918723,35418723,18500000,2018.csv,2018,65.7%,34.3%
201,Long Shot,53873809,30316271,23557538,2019.csv,2019,56.3%,43.7%
202,Teen Titans GO! to the Movies,52090236,29790236,22300000,2018.csv,2018,57.2%,42.8%
203,Slender Man,51738549,30569484,21169065,2018.csv,2018,59.1%,40.9%
204,Breaking In,51411620,46840590,4571030,2018.csv,2018,91.1%,8.9%
205,Once Upon a Deadpool 2018 Re-release,51247568,6100309,45147259,2018.csv,2018,11.9%,88.1%
206,Breakthrough,50444358,40713082,9731276,2019.csv,2019,80.7%,19.3%
207,Just Mercy,50401502,36001502,14400000,2019.csv,2019,71.4%,28.6%
208,Uncut Gems,50023780,50023780,0,2019.csv,2019,100%,-
209,21 Bridges,49939757,28539757,21400000,2019.csv,2019,57.1%,42.9%
210,Death Wish,49562710,34017028,15545682,2018.csv,2018,68.6%,31.4%
211,The Grudge,49511319,21221803,28289516,2020.csv,2020,42.9%,57.1%
212,Andhadhun,49391206,1193046,48198160,2018.csv,2018,2.4%,97.6%
213,Little,48987096,40860481,8126615,2019.csv,2019,83.4%,16.6%
214,Isn't It Romantic,48791187,48791187,0,2019.csv,2019,100%,-
215,Fantasy Island,48607556,26441782,22165774,2020.csv,2020,54.4%,45.6%
216,Countdown,48021766,25621766,22400000,2019.csv,2019,53.4%,46.6%
217,Queen & Slim,47489558,43808310,3681248,2019.csv,2019,92.2%,7.8%
218,Golden Job,47279677,285795,46993882,2018.csv,2018,0.6%,99.4%
219,Midsommar,46850563,27426361,19424202,2019.csv,2019,58.5%,41.5%
220,47 Meters Down: Uncaged,46783103,22260900,24522203,2019.csv,2019,47.6%,52.4%
221,Mary Queen of Scots,46710283,16468499,30241784,2018.csv,2018,35.3%,64.7%
222,Uncle Drew,46664414,42469946,4194468,2018.csv,2018,91%,9%
223,Tyler Perry's Acrimony,46403669,43549096,2854573,2018.csv,2018,93.8%,6.2%
224,Asterix: The Secret of the Magic Potion,46221204,1271953,44949251,2018.csv,2018,2.8%,97.2%
225,Chasing the Dragon II: Wild Wild Bunch,45733356,196634,45536722,2019.csv,2019,0.4%,99.6%
226,Child's Play,44902237,29208403,15693834,2019.csv,2019,65%,35%
227,Hellboy,44664690,21903748,22760942,2019.csv,2019,49%,51%
228,Winchester,44019588,25091816,18927772,2018.csv,2018,57%,43%
229,Richard Jewell,43745542,22345542,21400000,2019.csv,2019,51.1%,48.9%
230,Harriet,43282155,43082155,200000,2019.csv,2019,99.5%,0.5%
231,Annihilation,43070915,32732301,10338614,2018.csv,2018,76%,24%
232,The Possession of Hannah Grace,43016528,14837422,28179106,2018.csv,2018,34.5%,65.5%
233,Long Day's Journey Into Night,42140994,521365,41619629,2018.csv,2018,1.2%,98.8%
234,Judy,42077304,24313888,17763416,2019.csv,2019,57.8%,42.2%
235,Overlord,41657844,21704844,19953000,2018.csv,2018,52.1%,47.9%
236,The Great Battle,41509280,472166,41037114,2018.csv,2018,1.1%,98.9%
237,The Darkest Minds,41142379,12695691,28446688,2018.csv,2018,30.9%,69.1%
238,Underwater,40882928,17291078,23591850,2020.csv,2020,42.3%,57.7%
239,Fighting with My Family,40810036,22958886,17851150,2019.csv,2019,56.3%,43.7%
240,Holmes & Watson,40466970,30573626,9893344,2018.csv,2018,75.6%,24.4%
241,Show Dogs,39156854,17857020,21299834,2018.csv,2018,45.6%,54.4%
242,Believer,39047153,365639,38681514,2018.csv,2018,0.9%,99.1%
243,The Spy Gone North,38844509,500803,38343706,2018.csv,2018,1.3%,98.7%
244,On the Basis of Sex,38673750,24622687,14051063,2018.csv,2018,63.7%,36.3%
245,Overcomer,38026103,34746945,3279158,2019.csv,2019,91.4%,8.6%
246,Pain and Glory,37137074,4567338,32569736,2019.csv,2019,12.3%,87.7%
247,Till The End Of The World,37013733,118660,36895073,2018.csv,2018,0.3%,99.7%
248,The Intruder,36599361,35419122,1180239,2019.csv,2019,96.8%,3.2%
249,Nothing to Lose,36075317,1016188,35059129,2018.csv,2018,2.8%,97.2%
250,Mia and the White Lion,35906887,399471,35507416,2018.csv,2018,1.1%,98.9%
251,The Girl in the Spider's Web,35164920,14841338,20323582,2018.csv,2018,42.2%,57.8%
252,The Hate U Give,34934009,29719483,5214526,2018.csv,2018,85.1%,14.9%
253,Bad Guys: The Movie,34024386,166972,33857414,2019.csv,2019,0.5%,99.5%
254,The Good Liar,33856058,17156058,16700000,2019.csv,2019,50.7%,49.3%
255,The Art of Racing in the Rain,33766787,26395642,7371145,2019.csv,2019,78.2%,21.8%
256,Nobody's Fool,33705333,31713110,1992223,2018.csv,2018,94.1%,5.9%
257,Bharat,33185983,2971549,30214434,2019.csv,2019,9%,91%
258,Baaghi 2,33139063,1319579,31819484,2018.csv,2018,4%,96%
259,Brightburn,32893421,17300439,15592982,2019.csv,2019,52.6%,47.4%
260,The Hurricane Heist,32517248,6115825,26401423,2018.csv,2018,18.8%,81.2%
261,UglyDolls,32450241,20150241,12300000,2019.csv,2019,62.1%,37.9%
262,Stuber,32390945,22370452,10020493,2019.csv,2019,69.1%,30.9%
263,The Kid Who Would Be King,32140970,16790790,15350180,2019.csv,2019,52.2%,47.8%
264,Bad Times at the El Royale,31882724,17839115,14043609,2018.csv,2018,56%,44%
265,Hunter Killer,31672678,15767460,15905218,2018.csv,2018,49.8%,50.2%
266,Super Troopers 2,31626386,30617396,1008990,2018.csv,2018,96.8%,3.2%
267,Anna,31329947,7743794,23586153,2019.csv,2019,24.7%,75.3%
268,The Strangers: Prey at Night,31039126,24586708,6452418,2018.csv,2018,79.2%,20.8%
269,The Wild Goose Lake,31037956,12573,31025383,2019.csv,2019,<0.1%,100%
270,Like a Boss,29753143,22169514,7583629,2020.csv,2020,74.5%,25.5%
271,Bloodshot,29749454,10021787,19727667,2020.csv,2020,33.7%,66.3%
272,Free Solo,29318861,17541090,11777771,2018.csv,2018,59.8%,40.2%
273,Pad Man,29045020,1670192,27374828,2018.csv,2018,5.8%,94.2%
274,Gully Boy,28141995,5566534,22575461,2019.csv,2019,19.8%,80.2%
275,Default,27709716,203775,27505941,2018.csv,2018,0.7%,99.3%
276,One Cut of the Dead,27590180,52406,27537774,2018.csv,2018,0.2%,99.8%
277,Mirai,27526961,812794,26714167,2018.csv,2018,3%,97%
278,The Happytime Murders,27506452,20706452,6800000,2018.csv,2018,75.3%,24.7%
279,Midnight Sun,27365467,9561064,17804403,2018.csv,2018,34.9%,65.1%
280,My Neighbor Totoro 2018 Re-release,27083857,1144649,25939208,2018.csv,2018,4.2%,95.8%
281,Total Dhamaal,26911995,2167632,24744363,2019.csv,2019,8.1%,91.9%
282,No Manches Frida 2,26493648,9270920,17222728,2019.csv,2019,35%,65%
283,Missing Link,26249469,16649539,9599930,2019.csv,2019,63.4%,36.6%
284,Hichki,26055222,330279,25724943,2018.csv,2018,1.3%,98.7%
285,White Boy Rick,25957482,24011188,1946294,2018.csv,2018,92.5%,7.5%
286,"Paul, Apostle of Christ",25915966,17560475,8355491,2018.csv,2018,67.8%,32.2%
287,"The Gangster, the Cop, the Devil",25775371,216494,25558877,2019.csv,2019,0.8%,99.2%
288,Keys To The Heart,25375866,75134,25300732,2018.csv,2018,0.3%,99.7%
289,Emma.,25155355,10055355,15100000,2020.csv,2020,40%,60%
290,Booksmart,24863452,22680962,2182490,2019.csv,2019,91.2%,8.8%
291,Super 30,24701637,2269878,22431759,2019.csv,2019,9.2%,90.8%
292,Stan & Ollie,24420923,5470235,18950688,2018.csv,2018,22.4%,77.6%
293,The Accidental Detective 2: In Action,24243825,179045,24064780,2018.csv,2018,0.7%,99.3%
294,Pok√©mon the Movie: The Power of Us,23740788,789170,22951618,2018.csv,2018,3.3%,96.7%
295,Portrait of a Lady on Fire,23038758,3759854,19278904,2019.csv,2019,16.3%,83.7%
296,Padmaavat,22991060,11846060,11145000,2018.csv,2018,51.5%,48.5%
297,The Peanut Butter Falcon,22986166,20457151,2529015,2019.csv,2019,89%,11%
298,Won't You Be My Neighbor?,22842400,22835787,6613,2018.csv,2018,100%,<0.1%
299,Black and Blue,22741061,22055313,685748,2019.csv,2019,97%,3%
300,The Farewell,22459201,17695781,4763420,2019.csv,2019,78.8%,21.2%
301,Late Night,22386555,15499454,6887101,2019.csv,2019,69.2%,30.8%
302,Mojin: The Worm Valley,22381583,101516,22280067,2018.csv,2018,0.5%,99.5%
303,Big Brother,22029250,85624,21943626,2018.csv,2018,0.4%,99.6%
304,Gretel & Hansel,21984429,15347654,6636775,2020.csv,2020,69.8%,30.2%
305,Master Z: The Ip Man Legacy,21832649,209454,21623195,2018.csv,2018,1%,99%
306,Proud Mary,21753365,20877013,876352,2018.csv,2018,96%,4%
307,Dark Waters,21440704,11136084,10304620,2019.csv,2019,51.9%,48.1%
308,Shaft,21360215,21360215,0,2019.csv,2019,100%,-
309,Hotel Mumbai,21314816,9651611,11663205,2019.csv,2019,45.3%,54.7%
310,The Prodigy,21150265,14856291,6293974,2018.csv,2018,70.2%,29.8%
311,Unplanned,21051915,19005109,2046806,2019.csv,2019,90.3%,9.7%
312,Gonjiam: Haunted Asylum,21041950,115252,20926698,2018.csv,2018,0.5%,99.5%
313,My Hero Academia: Two Heroes,21022724,5754556,15268168,2018.csv,2018,27.4%,72.6%
314,SuperFly,20780685,20545116,235569,2018.csv,2018,98.9%,1.1%
315,If Beale Street Could Talk,20596567,14915773,5680794,2018.csv,2018,72.4%,27.6%
316,Burn the Stage: The Movie,20347513,4201819,16145694,2018.csv,2018,20.7%,79.3%
317,Brahms: The Boy II,20311536,12611536,7700000,2020.csv,2020,62.1%,37.9%
318,Cold War 2018 Re-release,20285066,4580048,15705018,2018.csv,2018,22.6%,77.4%
319,The Wife,19978189,9601092,10377097,2018.csv,2018,48.1%,51.9%
320,Everybody Knows,19176163,2660165,16515998,2018.csv,2018,13.9%,86.1%
321,They Shall Not Grow Old 2018 Re-release,19130011,17956913,1173098,2018.csv,2018,93.9%,6.1%
322,Oolong Courtyard: KungFu School,19129015,37727,19091288,2018.csv,2018,0.2%,99.8%
323,Always Miss You,19015465,91884,18923581,2019.csv,2019,0.5%,99.5%
324,Greta,18653107,10532219,8120888,2019.csv,2019,56.5%,43.5%
325,Peppa Celebrates Chinese New Year,18653040,131225,18521815,2019.csv,2019,0.7%,99.3%
326,Detective K: Secret of the Living Dead,18603476,104013,18499463,2018.csv,2018,0.6%,99.4%
327,The Lighthouse,18601951,10867104,7734847,2019.csv,2019,58.4%,41.6%
328,Black Christmas,18529730,10429730,8100000,2019.csv,2019,56.3%,43.7%
329,Airpocalypse,18491089,105678,18385411,2018.csv,2018,0.6%,99.4%
330,Motherless Brooklyn,18477736,9277736,9200000,2019.csv,2019,50.2%,49.8%
331,The Turning,18474062,15472775,3001287,2020.csv,2020,83.8%,16.2%
332,Chappaquiddick,18263470,17395520,867950,2018.csv,2018,95.2%,4.8%
333,Sorry to Bother You,18170707,17493096,677611,2018.csv,2018,96.3%,3.7%
334,Hell Fest,18159691,11107431,7052260,2018.csv,2018,61.2%,38.8%
335,Blinded by the Light,18019198,11901145,6118053,2019.csv,2019,66%,34%
336,Kalank,17987034,2729336,15257698,2019.csv,2019,15.2%,84.8%
337,The Old Man & the Gun,17860397,11277120,6583277,2018.csv,2018,63.1%,36.9%
338,The Children Act,17696794,547750,17149044,2018.csv,2018,3.1%,96.9%
339,Operation Finale,17612099,17612099,0,2018.csv,2018,100%,-
340,Loving Pablo,17535962,22017,17513945,2018.csv,2018,0.1%,99.9%
341,Fate/stay night [Heaven's Feel] II. lost butterfly,17295864,420595,16875269,2019.csv,2019,2.4%,97.6%
342,102 Not Out,16758596,1343797,15414799,2018.csv,2018,8%,92%
343,Beautiful Boy,16636604,7649973,8986631,2018.csv,2018,46%,54%
344,Nothing to Lose 2,16610713,1150551,15460162,2019.csv,2019,6.9%,93.1%
345,Upgrade,16593554,11977130,4616424,2018.csv,2018,72.2%,27.8%
346,Tazza: One-Eyed Jack,16572611,97655,16474956,2019.csv,2019,0.6%,99.4%
347,Poms,16418218,13631124,2787094,2019.csv,2019,83%,17%
348,Forever My Girl,16376066,16376066,0,2018.csv,2018,100%,-
349,Little Q,16360233,1652,16358581,2019.csv,2019,<0.1%,100%
350,Playmobil: The Movie,16349303,1115008,15234295,2019.csv,2019,6.8%,93.2%
351,Unfriended: Dark Web,16024987,8866745,7158242,2018.csv,2018,55.3%,44.7%
352,The Kitchen,15980032,12180032,3800000,2019.csv,2019,76.2%,23.8%
353,Finding Your Feet,15845593,1418682,14426911,2018.csv,2018,9%,91%
354,Feng Shui,15702302,64147,15638155,2018.csv,2018,0.4%,99.6%
355,Tully,15636462,9369755,6266707,2018.csv,2018,59.9%,40.1%
356,Miss Bala,15383580,15006824,376756,2019.csv,2019,97.6%,2.4%
357,Apollo 11,15342353,9039891,6302462,2019.csv,2019,58.9%,41.1%
358,The Negotiation,15229193,110986,15118207,2018.csv,2018,0.7%,99.3%
359,The Way Back,14690514,13590514,1100000,2020.csv,2020,92.5%,7.5%
360,The Dead Don't Die,14502830,6563605,7939225,2019.csv,2019,45.3%,54.7%
361,Serenity,14454622,8547045,5907577,2019.csv,2019,59.1%,40.9%
362,RBG,14441292,14017361,423931,2018.csv,2018,97.1%,2.9%
363,Eighth Grade,14347433,13539709,807724,2018.csv,2018,94.4%,5.6%
364,Thugs of Hindostan,14341431,1449848,12891583,2018.csv,2018,10.1%,89.9%
365,La Belle √âpoque,14298084,0,14298084,2020.csv,2020,-,100%
366,Unsane,14293601,7732899,6560702,2018.csv,2018,54.1%,45.9%
367,Colette,14273033,5137622,9135411,2018.csv,2018,36%,64%
368,Ya veremos,14134723,4165949,9968774,2018.csv,2018,29.5%,70.5%
369,The Quake,13837294,6235,13831059,2018.csv,2018,<0.1%,100%
370,Three Identical Strangers,13448497,12320845,1127652,2018.csv,2018,91.6%,8.4%
371,Hotel Artemis,13313581,6708147,6605434,2018.csv,2018,50.4%,49.6%
372,The Sisters Brothers,13143056,3143056,10000000,2018.csv,2018,23.9%,76.1%
373,Welcome to Marwen,13061491,10763520,2297971,2018.csv,2018,82.4%,17.6%
374,Take Point,12908032,112386,12795646,2018.csv,2018,0.9%,99.1%
375,Luis and the Aliens,12627729,169710,12458019,2018.csv,2018,1.3%,98.7%
376,Can You Ever Forgive Me?,12442161,8803865,3638296,2018.csv,2018,70.8%,29.2%
377,Rampant,12359573,167937,12191636,2018.csv,2018,1.4%,98.6%
378,Tall Tales from the Magical Garden of Antoon Krings 2018 Re-release,12353849,220,12353629,2018.csv,2018,<0.1%,100%
379,Little Women,12165890,1379497,10786393,2018.csv,2018,11.3%,88.7%
380,Miss & Mrs. Cops,12147170,104578,12042592,2019.csv,2019,0.9%,99.1%
381,Boy Erased,11853081,6788692,5064389,2018.csv,2018,57.3%,42.7%
382,Unstoppable,11845347,101417,11743930,2018.csv,2018,0.9%,99.1%
383,Last Letter,11834622,180946,11653676,2018.csv,2018,1.5%,98.5%
384,Ash Is Purest White,11813509,422814,11390695,2018.csv,2018,3.6%,96.4%
385,Ballon,11799591,34222,11765369,2018.csv,2018,0.3%,99.7%
386,The Divine Fury,11799556,102982,11696574,2019.csv,2019,0.9%,99.1%
387,The Current War: Director's Cut,11662493,5979540,5682953,2019.csv,2019,51.3%,48.7%
388,Bring The Soul: The Movie,11393886,4809800,6584086,2019.csv,2019,42.2%,57.8%
389,King of Thieves,11353515,7518,11345997,2018.csv,2018,<0.1%,99.9%
390,At Eternity's Gate,11261585,2294915,8966670,2018.csv,2018,20.4%,79.6%
391,Gloria Bell,11145006,5611123,5533883,2019.csv,2019,50.3%,49.7%
392,La boda de Valentina,11021794,2783739,8238055,2018.csv,2018,25.3%,74.7%
393,Gringo,11001627,4969853,6031774,2018.csv,2018,45.2%,54.8%
394,2.0,10847903,4152000,6695903,2018.csv,2018,38.3%,61.7%
395,Golden Slumber,10733326,94450,10638876,2018.csv,2018,0.9%,99.1%
396,Red Joan,10647493,1579730,9067763,2018.csv,2018,14.8%,85.2%
397,I Still Believe,10482561,9868521,614040,2020.csv,2020,94.1%,5.9%
398,Every Day,10421847,6102076,4319771,2018.csv,2018,58.6%,41.4%
399,"Where'd You Go, Bernadette",10411096,9198356,1212740,2019.csv,2019,88.4%,11.6%
400,Swing Kids,10397408,222001,10175407,2018.csv,2018,2.1%,97.9%
401,Lobster Cop,10373129,85693,10287436,2018.csv,2018,0.8%,99.2%
402,Kin,10313019,5718096,4594923,2018.csv,2018,55.4%,44.6%
403,Girls vs Gangsters,10265819,37115,10228704,2018.csv,2018,0.4%,99.6%
404,The Miracle Season,10230620,10230620,0,2018.csv,2018,100%,-
405,The Best of Enemies,10209813,10205616,4197,2019.csv,2019,100%,<0.1%
406,Ben Is Back,10134204,3703184,6431020,2018.csv,2018,36.5%,63.5%
407,BTS World Tour: Love Yourself in Seoul,10109421,3509917,6599504,2019.csv,2019,34.7%,65.3%
408,Papillon,10060903,2335896,7725007,2018.csv,2018,23.2%,76.8%
409,The Goldfinch,9932621,5332621,4600000,2019.csv,2019,53.7%,46.3%
410,The Princess and the Matchmaker,9899017,78900,9820117,2018.csv,2018,0.8%,99.2%
411,Simmba,9865268,5102129,4763139,2018.csv,2018,51.7%,48.3%
412,Arctic Dogs,9860619,5801249,4059370,2019.csv,2019,58.8%,41.2%
413,Tod@s Caen,9667157,2670925,6996232,2019.csv,2019,27.6%,72.4%
414,Official Secrets,9581462,1988546,7592916,2019.csv,2019,20.8%,79.2%
415,Promare,9548005,2313596,7234409,2019.csv,2019,24.2%,75.8%
416,Traffik,9515914,9186156,329758,2018.csv,2018,96.5%,3.5%
417,Replicas,9330075,4046429,5283646,2018.csv,2018,43.4%,56.6%
418,Mid90s,9303022,7362439,1940583,2018.csv,2018,79.1%,20.9%
419,The Aftermath,9215591,1618497,7597094,2019.csv,2019,17.6%,82.4%
420,Jexi,9172189,6546159,2626030,2019.csv,2019,71.4%,28.6%
421,Tolkien,9090040,4535154,4554886,2019.csv,2019,49.9%,50.1%
422,Champion,8974547,97472,8877075,2018.csv,2018,1.1%,98.9%
423,Captive State,8772812,5958315,2814497,2019.csv,2019,67.9%,32.1%
424,7 Days in Entebbe,8771432,3326885,5444547,2018.csv,2018,37.9%,62.1%
425,Code Geass: Lelouch of the Re;Surrection 2019 Re-release,8715612,522805,8192807,2019.csv,2019,6%,94%
426,The Traitor,8650229,296027,8354202,2019.csv,2019,3.4%,96.6%
427,Pope Francis: A Man of His Word,8608385,2008385,6600000,2018.csv,2018,23.3%,76.7%
428,Sorry We Missed You,8487343,28273,8459070,2019.csv,2019,0.3%,99.7%
429,A-X-L,8467697,6501381,1966316,2018.csv,2018,76.8%,23.2%
430,Disobedience,8003180,3498782,4504398,2018.csv,2018,43.7%,56.3%
431,Life Itself,7997774,4102648,3895126,2018.csv,2018,51.3%,48.7%
432,The Battle of Jangsari,7976445,70853,7905592,2019.csv,2019,0.9%,99.1%
433,Suspiria,7942093,2483472,5458621,2018.csv,2018,31.3%,68.7%
434,Pavarotti,7885016,4600249,3284767,2019.csv,2019,58.3%,41.7%
435,Qu√© Le√≥n,7807916,2607916,5200000,2018.csv,2018,33.4%,66.6%
436,Amazing Grace,7796112,4450456,3345656,2018.csv,2018,57.1%,42.9%
437,By the Grace of God,7755652,67059,7688593,2019.csv,2019,0.9%,99.1%
438,Love Live! Sunshine!! The School Idol Movie: Over The Rainbow,7733048,34135,7698913,2019.csv,2019,0.4%,99.6%
439,Penguins,7699452,7699452,0,2019.csv,2019,100%,-
440,Leave No Trace,7682928,6046104,1636824,2018.csv,2018,78.7%,21.3%
441,Pandas,7635778,7574012,61766,2018.csv,2018,99.2%,0.8%
442,The White Crow,7622595,1828784,5793811,2019.csv,2019,24%,76%
443,Burning,7566962,718991,6847971,2018.csv,2018,9.5%,90.5%
444,Beirut,7509436,5019226,2490210,2018.csv,2018,66.8%,33.2%
445,Brittany Runs a Marathon,7442106,7189808,252298,2019.csv,2019,96.6%,3.4%
446,Mayday Life,7435496,85912,7349584,2019.csv,2019,1.2%,98.8%
447,God's Not Dead: A Light in Darkness,7414178,5728940,1685238,2018.csv,2018,77.3%,22.7%
448,Return of the Hero,7362730,37108,7325622,2018.csv,2018,0.5%,99.5%
449,Wild Rose,7123449,1635117,5488332,2019.csv,2019,23%,77%
450,In Safe Hands,7086596,1737,7084859,2018.csv,2018,<0.1%,100%
451,Dog Days,6819044,6809080,9964,2018.csv,2018,99.9%,0.1%
452,Race 3,6817391,1690861,5126530,2018.csv,2018,24.8%,75.2%
453,The Sun Is Also a Star,6750029,4950029,1800000,2019.csv,2019,73.3%,26.7%
454,Fahrenheit 11/9,6674168,6352306,321862,2018.csv,2018,95.2%,4.8%
455,Soorma,6579645,390077,6189568,2018.csv,2018,5.9%,94.1%
456,National Theatre Live: Fleabag,6538919,326283,6212636,2019.csv,2019,5%,95%
457,The Hunt,6512500,5812500,700000,2020.csv,2020,89.3%,10.7%
458,Run the Race,6424420,6424420,0,2019.csv,2019,100%,-
459,Gotti,6412349,4343227,2069122,2018.csv,2018,67.7%,32.3%
460,The Mustang,6405816,5043620,1362196,2019.csv,2019,78.7%,21.3%
461,Las Pildoras De Mi Novio,6292780,2971116,3321664,2020.csv,2020,47.2%,52.8%
462,Unbroken: Path to Redemption,6216897,6216897,0,2018.csv,2018,100%,-
463,Immortal Hero,6180032,43007,6137025,2019.csv,2019,0.7%,99.3%
464,The Professor and the Madman,6162010,0,6162010,2019.csv,2019,-,100%
465,Ploey,6146292,77815,6068477,2018.csv,2018,1.3%,98.7%
466,Mobile Suit Gundam Narrative,6126259,259224,5867035,2018.csv,2018,4.2%,95.8%
467,The Rhythm Section,5989583,5437971,551612,2020.csv,2020,90.8%,9.2%
468,"Cyrano, My Love",5982358,351019,5631339,2019.csv,2019,5.9%,94.1%
469,Death of a Nation,5885881,5885881,0,2018.csv,2018,100%,-
470,Furie,5717640,594788,5122852,2019.csv,2019,10.4%,89.6%
471,Saaho,5708522,2872057,2836465,2019.csv,2019,50.3%,49.7%
472,Mission Mangal,5667057,3659413,2007644,2019.csv,2019,64.6%,35.4%
473,Incident in a Ghostland,5643957,0,5643957,2018.csv,2018,-,100%
474,El Angel,5604680,109608,5495072,2018.csv,2018,2%,98%
475,Destroyer,5580940,1533324,4047616,2018.csv,2018,27.5%,72.5%
476,A Wizard's Tale,5487261,2150,5485111,2018.csv,2018,<0.1%,100%
477,Don't Let Go,5288011,5215062,72949,2019.csv,2019,98.6%,1.4%
478,The Biggest Little Farm,5247328,4366949,880379,2019.csv,2019,83.2%,16.8%
479,Never Look Away,5156805,1304042,3852763,2018.csv,2018,25.3%,74.7%
480,Action Point,5103663,5059608,44055,2018.csv,2018,99.1%,0.9%
481,Dogman,5080147,148225,4931922,2018.csv,2018,2.9%,97.1%
482,Konosuba!: God's Blessing on This Wonderful World! - Legend of Crimson,5078942,1134786,3944156,2019.csv,2019,22.3%,77.7%
483,Blindspotting,5006989,4333394,673595,2018.csv,2018,86.5%,13.5%
484,Sgt. Stubby: An American Hero,4932694,4015935,916759,2018.csv,2018,81.4%,18.6%
485,Samson,4873825,4719928,153897,2018.csv,2018,96.8%,3.2%
486,Menteur,4697364,4697364,0,2019.csv,2019,100%,-
487,Jay and Silent Bob Reboot,4691248,4589490,101758,2019.csv,2019,97.8%,2.2%
488,Hamlet 2018 Re-release,4630718,235229,4395489,2018.csv,2018,5.1%,94.9%
489,Housefull 4,4624936,2109160,2515776,2019.csv,2019,45.6%,54.4%
490,Bad Samaritan,4623836,3435047,1188789,2018.csv,2018,74.3%,25.7%
491,A Hidden Life,4608154,1730597,2877557,2019.csv,2019,37.6%,62.4%
492,The Last Black Man in San Francisco,4607017,4515719,91298,2019.csv,2019,98%,2%
493,Whitney,4605123,3026351,1578772,2018.csv,2018,65.7%,34.3%
494,The Guilty,4598051,207140,4390911,2018.csv,2018,4.5%,95.5%
495,The Beach Bum,4554416,3502600,1051816,2019.csv,2019,76.9%,23.1%
496,"Juliet, Naked",4508260,3444895,1063365,2018.csv,2018,76.4%,23.6%
497,Woman at War,4471158,847495,3623663,2018.csv,2018,19%,81%
498,My Spy,4405156,0,4405156,2020.csv,2020,-,100%
499,Brian Banks,4376819,4376819,0,2019.csv,2019,100%,-
500,Uri: The Surgical Strike 2019 Re-release,4302454,4186168,116286,2019.csv,2019,97.3%,2.7%
501,Swift,4299329,0,4299329,2019.csv,2019,-,100%
502,Storm Boy,4266224,71760,4194464,2018.csv,2018,1.7%,98.3%
503,Linda Ronstadt: The Sound of My Voice,4252657,4252657,0,2019.csv,2019,100%,-
504,"Don't Worry, He Won't Get Far on Foot",4241656,1441705,2799951,2018.csv,2018,34%,66%
505,Savage,4140502,74491,4066011,2019.csv,2019,1.8%,98.2%
506,Ghost Stories,4131358,148747,3982611,2018.csv,2018,3.6%,96.4%
507,Arctic 2019 Re-release,4124015,2410795,1713220,2019.csv,2019,58.5%,41.5%
508,The Fall of the American Empire,4110928,2178460,1932468,2018.csv,2018,53%,47%
509,American Animals,4080073,2856954,1223119,2018.csv,2018,70%,30%
510,Junglee,4033587,295784,3737803,2019.csv,2019,7.3%,92.7%
511,Penguin Highway,4006647,104567,3902080,2018.csv,2018,2.6%,97.4%
512,Lucifer,3956978,0,3956978,2019.csv,2019,-,100%
513,Ride Your Wave,3927015,332432,3594583,2019.csv,2019,8.5%,91.5%
514,A Private War,3915207,1633208,2281999,2018.csv,2018,41.7%,58.3%
515,First Reformed,3862498,3448256,414242,2018.csv,2018,89.3%,10.7%
516,Custody,3790303,83882,3706421,2018.csv,2018,2.2%,97.8%
517,Night of 7 Years,3716820,24281,3692539,2018.csv,2018,0.7%,99.3%
518,Western Stars,3681681,1581681,2100000,2019.csv,2019,43%,57%
519,Gosnell: The Trial of America's Biggest Serial Killer,3679893,3679893,0,2018.csv,2018,100%,-
520,Non-Fiction,3648552,704919,2943633,2018.csv,2018,19.3%,80.7%
521,Badla,3590894,1861000,1729894,2019.csv,2019,51.8%,48.2%
522,Indivisible,3589633,3511417,78216,2018.csv,2018,97.8%,2.2%
523,The Apparition,3562793,28293,3534500,2018.csv,2018,0.8%,99.2%
524,The Oscar Nominated Short Films 2019: Documentary,3538550,3531094,7456,2019.csv,2019,99.8%,0.2%
525,Ek Ladki Ko Dekha Toh Aisa Laga,3531837,1182636,2349201,2019.csv,2019,33.5%,66.5%
526,The Oscar Nominated Short Films 2018: Live Action,3511123,3508777,2346,2018.csv,2018,99.9%,<0.1%
527,Faustina: Love and Mercy,3498887,2243180,1255707,2019.csv,2019,64.1%,35.9%
528,Maiden,3495241,3168978,326263,2019.csv,2019,90.7%,9.3%
529,The Metropolitan Opera HD Live: Puccini: Tosca,3473616,2023749,1449867,2018.csv,2018,58.3%,41.7%
530,Racetime,3439053,1875283,1563770,2018.csv,2018,54.5%,45.5%
531,The Rider,3434963,2419031,1015932,2018.csv,2018,70.4%,29.6%
532,Bacurau,3423433,58115,3365318,2019.csv,2019,1.7%,98.3%
533,Midnight Diner,3412771,18555,3394216,2019.csv,2019,0.5%,99.5%
534,Friends 25th: The One With The Anniversary,3403406,2884827,518579,2019.csv,2019,84.8%,15.2%
535,The Hole in the Ground,3373474,21072,3352402,2019.csv,2019,0.6%,99.4%
536,Patrick the Pug,3369468,6290,3363178,2018.csv,2018,0.2%,99.8%
537,Echo in the Canyon,3355324,3355324,0,2019.csv,2019,100%,-
538,On Chesil Beach,3335913,745971,2589942,2018.csv,2018,22.4%,77.6%
539,The Death and Life of John F. Donovan,3326364,152713,3173651,2019.csv,2019,4.6%,95.4%
540,Breath,3322479,37108,3285371,2018.csv,2018,1.1%,98.9%
541,Wildlife,3321367,1050616,2270751,2018.csv,2018,31.6%,68.4%
542,Chhichhore,3307350,2004400,1302950,2019.csv,2019,60.6%,39.4%
543,The House That Jack Built,3297010,170113,3126897,2018.csv,2018,5.2%,94.8%
544,Bharath Ane Nenu,3276257,2663090,613167,2018.csv,2018,81.3%,18.7%
545,Honey Boy,3270077,3012615,257462,2019.csv,2019,92.1%,7.9%
546,Marianne & Leonard: Words of Love,3260620,1012034,2248586,2019.csv,2019,31%,69%
547,The Front Runner,3242235,2000105,1242130,2018.csv,2018,61.7%,38.3%
548,Thoroughbreds,3187255,3072605,114650,2018.csv,2018,96.4%,3.6%
549,Tea With the Dames,3181152,889343,2291809,2018.csv,2018,28%,72%
550,Pilgrim's Progress,3173282,1294596,1878686,2019.csv,2019,40.8%,59.2%
551,All Is True,3019143,1200481,1818662,2019.csv,2019,39.8%,60.2%
552,The Last Full Measure,3006059,2949212,56847,2020.csv,2020,98.1%,1.9%
553,Made for More,2999134,2999134,0,2018.csv,2018,100%,-
554,Memoir of War,2980982,103636,2877346,2018.csv,2018,3.5%,96.5%
555,The Aeronauts,2907225,0,2907225,2019.csv,2019,-,100%
556,God Bless the Broken Road,2848233,2846257,1976,2018.csv,2018,99.9%,<0.1%
557,Children of the Sea,2843206,0,2843206,2019.csv,2019,-,100%
558,Hold Your Breath,2842040,77987,2764053,2018.csv,2018,2.7%,97.3%
559,McQueen,2739246,1257275,1481971,2018.csv,2018,45.9%,54.1%
560,Edie,2731170,71790,2659380,2018.csv,2018,2.6%,97.4%
561,Billionaire Boys Club,2713955,1349,2712606,2018.csv,2018,<0.1%,100%
562,Metallica & San Francisco Symphony - S&M2,2705442,1252385,1453057,2019.csv,2019,46.3%,53.7%
563,After the Wedding,2694607,1574258,1120349,2019.csv,2019,58.4%,41.6%
564,The Lodge,2679438,1666564,1012874,2020.csv,2020,62.2%,37.8%
565,Diego Maradona,2656890,0,2656890,2019.csv,2019,-,100%
566,Kinky Boots: The Musical,2635571,900451,1735120,2019.csv,2019,34.2%,65.8%
567,The Happy Prince,2621992,466440,2155552,2018.csv,2018,17.8%,82.2%
568,The Little Mermaid,2610742,147175,2463567,2018.csv,2018,5.6%,94.4%
569,Zero,2595762,1035388,1560374,2018.csv,2018,39.9%,60.1%
570,Leo Da Vinci: Mission Mona Lisa,2588859,19978,2568881,2018.csv,2018,0.8%,99.2%
571,Assassination Nation,2584988,2005142,579846,2018.csv,2018,77.6%,22.4%
572,Maquia: When the Promised Flower Blooms 2018 Re-release,2569927,18539,2551388,2018.csv,2018,0.7%,99.3%
573,Spirits in the Forest,2531785,704744,1827041,2019.csv,2019,27.8%,72.2%
574,Birds of Passage,2517349,507259,2010090,2018.csv,2018,20.2%,79.8%
575,Polaroid,2489778,0,2489778,2019.csv,2019,-,100%
576,"One Nation, One King",2481681,6576,2475105,2018.csv,2018,0.3%,99.7%
577,Lean on Pete,2443584,1163056,1280528,2018.csv,2018,47.6%,52.4%
578,The Informer,2441411,0,2441411,2019.csv,2019,-,100%
579,The Breadwinner 2018 Re-release,2426907,834,2426073,2018.csv,2018,<0.1%,100%
580,Hearts Beat Loud,2417165,2386251,30914,2018.csv,2018,98.7%,1.3%
581,The Art of Self-Defense,2414269,2410914,3355,2019.csv,2019,99.9%,0.1%
582,Sound! Euphonium the Movie - Our Promise: A Brand New Day,2403030,90341,2312689,2019.csv,2019,3.8%,96.2%
583,The Man Who Killed Don Quixote,2390383,391963,1998420,2018.csv,2018,16.4%,83.6%
584,1991,2342264,2342264,0,2018.csv,2018,100%,-
585,Piranhas,2298525,23494,2275031,2019.csv,2019,1%,99%
586,3 from Hell,2295825,2172949,122876,2019.csv,2019,94.6%,5.4%
587,The House That Jack Built 2018 Re-release,2268855,87993,2180862,2018.csv,2018,3.9%,96.1%
588,Luce,2268204,2010613,257591,2019.csv,2019,88.6%,11.4%
589,Puzzle,2260946,2032018,228928,2018.csv,2018,89.9%,10.1%
590,An Interview with God,2251795,1201434,1050361,2018.csv,2018,53.4%,46.6%
591,At War,2235052,4605,2230447,2018.csv,2018,0.2%,99.8%
592,3 Faces,2191516,72324,2119192,2018.csv,2018,3.3%,96.7%
593,Maria By Callas 2018 Re-release,2185562,1267301,918261,2018.csv,2018,58%,42%
594,Border,2177678,771930,1405748,2018.csv,2018,35.4%,64.6%
595,Gone with the Wind 2019 Re-release,2176120,2176120,0,2019.csv,2019,100%,-
596,Veere Di Wedding,2176099,0,2176099,2018.csv,2018,-,100%
597,High Life,2133033,1225852,907181,2018.csv,2018,57.5%,42.5%
598,Indian Horse,2097362,2097362,0,2018.csv,2018,100%,-
599,Mary Shelley,2096600,108900,1987700,2018.csv,2018,5.2%,94.8%
600,The Wizard of Oz 2019 Re-release,2076020,2076020,0,2019.csv,2019,100%,-
601,Black '47,2073063,57520,2015543,2018.csv,2018,2.8%,97.2%
602,Under the Silver Lake,2053469,46083,2007386,2018.csv,2018,2.2%,97.8%
603,Raid,2031135,1010385,1020750,2018.csv,2018,49.7%,50.3%
604,Waves,2027629,1658790,368839,2019.csv,2019,81.8%,18.2%
605,Climax,2027391,817339,1210052,2018.csv,2018,40.3%,59.7%
606,Peterloo,1998945,151971,1846974,2018.csv,2018,7.6%,92.4%
607,The Metropolitan Opera HD Live: Verdi: La Traviata,1982588,1882931,99657,2018.csv,2018,95%,5%
608,Maquia: When the Promised Flower Blooms,1979604,185699,1793905,2018.csv,2018,9.4%,90.6%
609,42nd Street: The Musical,1967450,187440,1780010,2019.csv,2019,9.5%,90.5%
610,Beanpole,1950414,196258,1754156,2019.csv,2019,10.1%,89.9%
611,Luka Chuppi,1923586,1042905,880681,2019.csv,2019,54.2%,45.8%
612,The Pact,1855647,2488,1853159,2018.csv,2018,0.1%,99.9%
613,Fantastic Fungi,1849050,1788322,60728,2019.csv,2019,96.7%,3.3%
614,Sweet Country,1847693,104297,1743396,2018.csv,2018,5.6%,94.4%
615,The Little Stranger,1824902,713143,1111759,2018.csv,2018,39.1%,60.9%
616,The Seagull,1820461,1252960,567501,2018.csv,2018,68.8%,31.2%
617,The Other Side of Heaven 2: Fire of Faith,1807216,1807216,0,2019.csv,2019,100%,-
618,Moses,1807117,1807117,0,2018.csv,2018,100%,-
619,The Metropolitan Opera HD Live: Puccini: La Boh√®me,1764201,1764201,0,2018.csv,2018,100%,-
620,Trolls World Tour,1758185,0,1758185,2020.csv,2020,-,100%
621,The Metropolitan Opera HD Live: Massenet: Cendrillon,1747259,1243306,503953,2018.csv,2018,71.2%,28.8%
622,Beast,1744071,800365,943706,2018.csv,2018,45.9%,54.1%
623,A Faithful Man,1720605,77491,1643114,2018.csv,2018,4.5%,95.5%
624,The Souvenir,1719157,1036737,682420,2019.csv,2019,60.3%,39.7%
625,Invisible Life,1716237,146535,1569702,2019.csv,2019,8.5%,91.5%
626,Grease 2018 Re-release,1710727,1213413,497314,2018.csv,2018,70.9%,29.1%
627,Matthias & Maxime,1696938,374739,1322199,2019.csv,2019,22.1%,77.9%
628,The Wild Pear Tree,1696258,34014,1662244,2018.csv,2018,2%,98%
629,La femme de mon fr√®re,1671969,539524,1132445,2019.csv,2019,32.3%,67.7%
630,Deerskin,1656279,0,1656279,2019.csv,2019,-,100%
631,Sorry Angel,1636273,30628,1605645,2018.csv,2018,1.9%,98.1%
632,Student of the Year 2,1635907,778566,857341,2019.csv,2019,47.6%,52.4%
633,I Still See You,1620637,1359,1619278,2018.csv,2018,<0.1%,99.9%
634,The Metropolitan Opera HD Live: Verdi: Aida,1595902,1595902,0,2018.csv,2018,100%,-
635,Made in India,1594164,790628,803536,2018.csv,2018,49.6%,50.4%
636,The Crossing,1589212,90896,1498316,2019.csv,2019,5.7%,94.3%
637,Teen Spirit,1573601,441366,1132235,2019.csv,2019,28%,72%
638,The Kid,1553483,1508593,44890,2019.csv,2019,97.1%,2.9%
639,Yardie,1551163,36012,1515151,2018.csv,2018,2.3%,97.7%
640,Tel Aviv on Fire,1548893,506145,1042748,2019.csv,2019,32.7%,67.3%
641,Mystery Train,1544973,1541218,3755,2018.csv,2018,99.8%,0.2%
642,The Chaperone,1541223,600654,940569,2019.csv,2019,39%,61%
643,Kedarnath,1538846,901131,637715,2018.csv,2018,58.6%,41.4%
644,Monos,1534584,406473,1128111,2019.csv,2019,26.5%,73.5%
645,Princess Mononoke 2018 Re-release,1519321,1423877,95444,2018.csv,2018,93.7%,6.3%
646,De De Pyaar De,1473116,425934,1047182,2019.csv,2019,28.9%,71.1%
647,The Miseducation of Cameron Post,1451729,904703,547026,2018.csv,2018,62.3%,37.7%
648,The Dawn Wall 2018 Re-release,1442013,970032,471981,2018.csv,2018,67.3%,32.7%
649,It 2019 Re-release,1414696,1347126,67570,2019.csv,2019,95.2%,4.8%
650,El Chicano,1404646,1400603,4043,2019.csv,2019,99.7%,0.3%
651,Vox Lux,1399272,727119,672153,2018.csv,2018,52%,48%
652,Sometimes Always Never,1377856,0,1377856,2018.csv,2018,-,100%
653,Swimming with Men,1377748,24708,1353040,2018.csv,2018,1.8%,98.2%
654,For Sama,1374201,43796,1330405,2019.csv,2019,3.2%,96.8%
655,Little Italy,1362536,990230,372306,2018.csv,2018,72.7%,27.3%
656,Alien 2019 Re-release,1356259,833658,522601,2019.csv,2019,61.5%,38.5%
657,Foxtrot,1356159,618883,737276,2018.csv,2018,45.6%,54.4%
658,Mandy,1335484,1214525,120959,2018.csv,2018,90.9%,9.1%
659,The Metropolitan Opera HD Live: Rossini: Semiramide,1332900,1033651,299249,2018.csv,2018,77.5%,22.5%
660,The Metropolitan Opera HD Live: Mozart: Cos√¨ fan tutte,1302949,1302949,0,2018.csv,2018,100%,-
661,Roger Waters - Us + Them,1294480,611644,682836,2019.csv,2019,47.3%,52.7%
662,The Cakemaker,1287568,875751,411817,2018.csv,2018,68%,32%
663,Shed Skin Papa,1278065,13331,1264734,2018.csv,2018,1%,99%
664,Yellow Submarine,1273261,992305,280956,2018.csv,2018,77.9%,22.1%
665,Beautifully Broken,1271572,1209645,61927,2018.csv,2018,95.1%,4.9%
666,Fagara,1265949,43417,1222532,2019.csv,2019,3.4%,96.6%
667,Batla House,1264337,493180,771157,2019.csv,2019,39%,61%
668,Guy,1257937,1319,1256618,2018.csv,2018,0.1%,99.9%
669,BTS World Tour 'Love Yourself: Speak Yourself' (The Final) Seoul Live Viewing,1226552,1226552,0,2019.csv,2019,100%,-
670,The Captain,1196669,109226,1087443,2018.csv,2018,9.1%,90.9%
671,The Metropolitan Opera HD Live: Saint-Sa√´ns: Samson et Dalila,1195758,1195758,0,2018.csv,2018,100%,-
672,Kingdom Men Rising,1188936,1188936,0,2019.csv,2019,100%,-
673,Los Domirrique√±os 2,1187280,1187280,0,2019.csv,2019,100%,-
674,National Theater Live: Cyrano de Bergerac,1173512,86300,1087212,2019.csv,2019,7.4%,92.6%
675,The Metropolitan Opera HD Live: Verdi: Luisa Miller,1166858,1166858,0,2018.csv,2018,100%,-
676,Elliot the Littlest Reindeer 2018 Re-release,1142187,24262,1117925,2018.csv,2018,2.1%,97.9%
677,Honeyland,1140879,815082,325797,2019.csv,2019,71.4%,28.6%
678,Roma,1140769,0,1140769,2018.csv,2018,-,100%
679,The Song of Names,1138700,1077584,61116,2019.csv,2019,94.6%,5.4%
680,Look Away,1119537,0,1119537,2018.csv,2018,-,100%
681,The Metropolitan Opera HD Live: Donizetti: L'Elisir d'Amore,1115018,1115018,0,2018.csv,2018,100%,-
682,My Neighbor Totoro 2019 Re-release,1105564,1105564,0,2019.csv,2019,100%,-
683,El Coyote,1101470,1101470,0,2019.csv,2019,100%,-
684,The Goonies 2019 Re-release,1089463,864378,225085,2019.csv,2019,79.3%,20.7%
685,The Sky Is Pink,1088641,652592,436049,2019.csv,2019,59.9%,40.1%
686,Sunset,1083299,164906,918393,2018.csv,2018,15.2%,84.8%
687,Jesus Is King,1082629,973000,109629,2019.csv,2019,89.9%,10.1%
688,Mystify: Michael Hutchence,1082456,289573,792883,2019.csv,2019,26.8%,73.2%
689,Bennett's War,1056416,1056416,0,2019.csv,2019,100%,-
690,The Dark Crystal 2018 Re-release,1036956,1036956,0,2018.csv,2018,100%,-
691,Noah: The Musical,1035603,1035603,0,2019.csv,2019,100%,-
692,The Metropolitan Opera HD Live: Puccini: La Fanciulla del West,1023233,1023233,0,2018.csv,2018,100%,-
693,Husband Material,1016545,567417,449128,2018.csv,2018,55.8%,44.2%
694,Elvis: The Comeback Special,1010657,1010657,0,2018.csv,2018,100%,-
695,Cold Blood,1009888,5083,1004805,2019.csv,2019,0.5%,99.5%
696,Kiki's Delivery Service 2019 Re-release,1004057,1004057,0,2019.csv,2019,100%,-
697,National Theatre Live: Antony & Cleopatra,998079,83672,914407,2018.csv,2018,8.4%,91.6%
698,Photograph,996171,344534,651637,2019.csv,2019,34.6%,65.4%
699,Labyrinth 2018 Re-release,993336,993336,0,2018.csv,2018,100%,-
700,Miles Davis: Birth of the Cool,984499,614201,370298,2019.csv,2019,62.4%,37.6%
701,Transit,982372,815290,167082,2018.csv,2018,83%,17%
702,Schindler's List 2018 Re-release,981489,833050,148439,2018.csv,2018,84.9%,15.1%
703,Journey's End,970809,161796,809013,2018.csv,2018,16.7%,83.3%
704,Ryuichi Sakamoto: Coda,960212,117460,842752,2018.csv,2018,12.2%,87.8%
705,Rush: Cinema Strangiato 2019,960073,960073,0,2019.csv,2019,100%,-
706,A Prayer Before Dawn,958883,14453,944430,2018.csv,2018,1.5%,98.5%
707,The Endless,956425,272020,684405,2018.csv,2018,28.4%,71.6%
708,The Fighting Preacher,954641,954641,0,2019.csv,2019,100%,-
709,The Catcher Was a Spy,953953,725223,228730,2018.csv,2018,76%,24%
710,Becoming Astrid,938766,120486,818280,2018.csv,2018,12.8%,87.2%
711,White Christmas 2018 Re-release,928298,928298,0,2018.csv,2018,100%,-
712,Like Arrows,928265,817990,110275,2018.csv,2018,88.1%,11.9%
713,Toni Morrison: The Pieces I Am,927495,903018,24477,2019.csv,2019,97.4%,2.6%
714,Kirk Cameron: Connect,918127,918127,0,2018.csv,2018,100%,-
715,The Lodgers,916727,7362,909365,2018.csv,2018,0.8%,99.2%
716,Revenge,913331,102091,811240,2018.csv,2018,11.2%,88.8%
717,Kings,910269,274635,635634,2018.csv,2018,30.2%,69.8%
718,The Hummingbird Project,899037,371784,527253,2019.csv,2019,41.4%,58.6%
719,The Game Changers,897992,739711,158281,2019.csv,2019,82.4%,17.6%
720,Between Me and My Mind,875191,875191,0,2019.csv,2019,100%,-
721,Howl's Moving Castle 2019 Re-release,865647,865647,0,2019.csv,2019,100%,-
722,The Metropolitan Opera HD Live: Nico Muhly: Marnie,865551,849710,15841,2018.csv,2018,98.2%,1.8%
723,The Nightingale,855756,400209,455547,2019.csv,2019,46.8%,53.2%
724,Steel Magnolias 2019 Re-release,855421,855421,0,2019.csv,2019,100%,-
725,Lizzie,844786,642157,202629,2018.csv,2018,76%,24%
726,BANDSTAND: The Broadway Musical on Screen,839554,839554,0,2018.csv,2018,100%,-
727,The Whistlers,833602,55608,777994,2019.csv,2019,6.7%,93.3%
728,Vita & Virginia,815419,42741,772678,2019.csv,2019,5.2%,94.8%
729,The Heiresses,811196,78473,732723,2018.csv,2018,9.7%,90.3%
730,Joni 75: A Birthday Celebration,808831,752205,56626,2019.csv,2019,93%,7%
731,Chonda Pierce: Unashamed,787979,787979,0,2019.csv,2019,100%,-
732,Mrs. Hyde,778142,18627,759515,2018.csv,2018,2.4%,97.6%
733,The Church,772000,772000,0,2019.csv,2019,100%,-
734,DanTDM Presents The Contest,765363,307484,457879,2019.csv,2019,40.2%,59.8%
735,Patterns of Evidence: Moses Controversy,765361,765361,0,2019.csv,2019,100%,-
736,The Invisibles,764250,407373,356877,2018.csv,2018,53.3%,46.7%
737,Pick of the Litter,763688,578717,184971,2018.csv,2018,75.8%,24.2%
738,Museo,759626,148505,611121,2018.csv,2018,19.5%,80.5%
739,Boundaries,755977,703438,52539,2018.csv,2018,93.1%,6.9%
740,I Love Lucy: A Colorized Celebration,754323,754323,0,2019.csv,2019,100%,-
741,Ramen Shop,734347,88455,645892,2018.csv,2018,12%,88%
742,David Crosby: Remember My Name,732793,732793,0,2019.csv,2019,100%,-
743,The Polar Express 2018 Re-release,731018,731018,0,2018.csv,2018,100%,-
744,Slaughterhouse Rulez,730762,4665,726097,2018.csv,2018,0.6%,99.4%
745,Liz and the Blue Bird,726454,63204,663250,2018.csv,2018,8.7%,91.3%
746,Aquarela,725269,307346,417923,2019.csv,2019,42.4%,57.6%
747,Where's My Roy Cohn?,722603,705274,17329,2019.csv,2019,97.6%,2.4%
748,HBO Boxing: Canelo Alvarez vs. Gennady Golovkin II,707875,707875,0,2018.csv,2018,100%,-
749,Itzhak,704968,607290,97678,2018.csv,2018,86.1%,13.9%
750,Blaze,704955,704955,0,2018.csv,2018,100%,-
751,Frankie,695680,171781,523899,2019.csv,2019,24.7%,75.3%
752,The Least of These: The Graham Staines Story,695164,607015,88149,2019.csv,2019,87.3%,12.7%
753,Jim Henson's Holiday Special with Fraggle Rock and Emmet Otter,695130,695130,0,2018.csv,2018,100%,-
754,In the Aisles,694586,28394,666192,2018.csv,2018,4.1%,95.9%
755,Raise Hell: The Life & Times of Molly Ivins,694410,694410,0,2019.csv,2019,100%,-
756,Romeo Akbar Walter,688719,236299,452420,2019.csv,2019,34.3%,65.7%
757,Bethany Hamilton: Unstoppable,684078,590671,93407,2019.csv,2019,86.3%,13.7%
758,The Trump Prophecy,671198,671198,0,2018.csv,2018,100%,-
759,Anna and the Apocalypse,670430,545597,124833,2018.csv,2018,81.4%,18.6%
760,Stockholm,665527,292590,372937,2019.csv,2019,44%,56%
761,Dragon Ball Z: Broly - The Legendary Super Saiyan,658982,658982,0,2018.csv,2018,100%,-
762,Ponyo 2018 Re-release,653072,653072,0,2018.csv,2018,100%,-
763,The Public,644740,573503,71237,2019.csv,2019,89%,11%
764,Seberg,640804,434702,206102,2019.csv,2019,67.8%,32.2%
765,Batti Gul Meter Chalu,635869,249539,386330,2018.csv,2018,39.2%,60.8%
766,Asako I & II,627102,25559,601543,2019.csv,2019,4.1%,95.9%
767,"Love, Gilda",626318,626318,0,2018.csv,2018,100%,-
768,The Sound of Music 2018 Re-release,624392,616171,8221,2018.csv,2018,98.7%,1.3%
769,Give Me Liberty,624152,242734,381418,2019.csv,2019,38.9%,61.1%
770,Nancy Drew and the Hidden Staircase,623088,623088,0,2019.csv,2019,100%,-
771,Dirty Dancing 2019 Re-release,622968,622968,0,2019.csv,2019,100%,-
772,Die Hard 30th Anniversary Release,620525,510241,110284,2018.csv,2018,82.2%,17.8%
773,The Transformers,619597,619597,0,2018.csv,2018,100%,-
774,Synonyms,615592,206003,409589,2019.csv,2019,33.5%,66.5%
775,Killerman,614366,291477,322889,2019.csv,2019,47.4%,52.6%
776,The Muppet Movie 2019 Re-release,610475,610475,0,2019.csv,2019,100%,-
777,The Reports on Sarah and Saleem,607206,117479,489727,2018.csv,2018,19.3%,80.7%
778,The Walking Dead: Wrath/The Walking Dead/Fear the Walking Dead: What's Your Story?/Fear the Walking Dead,605764,605764,0,2018.csv,2018,100%,-
779,The Golden Glove,604147,6160,597987,2019.csv,2019,1%,99%
780,"DCI 2019: Big, Loud & Live 16",603320,603320,0,2018.csv,2018,100%,-
781,Oh Lucy!,600145,375391,224754,2018.csv,2018,62.6%,37.4%
782,The Big Lebowski 2018 Re-release,592832,582585,10247,2018.csv,2018,98.3%,1.7%
783,To Kill a Mockingbird 2019 Re-release,592237,592237,0,2019.csv,2019,100%,-
784,The Cure: Anniversary 1978-2018 Live in Hyde Park,591904,378405,213499,2019.csv,2019,63.9%,36.1%
785,The Wonderland,591857,50876,540981,2019.csv,2019,8.6%,91.4%
786,Bilal: A New Breed of Hero 2018 Re-release,576805,490973,85832,2018.csv,2018,85.1%,14.9%
787,The Painted Bird,573850,0,573850,2019.csv,2019,-,100%
788,The Cat Returns 2018 Re-release,563718,563718,0,2018.csv,2018,100%,-
789,Beetlejuice 2018 Re-release,562613,512947,49666,2018.csv,2018,91.2%,8.8%
790,My Fair Lady 2019 Re-release,560711,560711,0,2019.csv,2019,100%,-
791,Fiddler: A Miracle of Miracles,558816,549386,9430,2019.csv,2019,98.3%,1.7%
792,Kusama: Infinity,558052,360931,197121,2018.csv,2018,64.7%,35.3%
793,Castle in the Sky 2018 Re-release,557541,523664,33877,2018.csv,2018,93.9%,6.1%
794,Rojo,557092,94757,462335,2018.csv,2018,17%,83%
795,Dhadak,549628,0,549628,2018.csv,2018,-,100%
796,Light of My Life,547161,20056,527105,2019.csv,2019,3.7%,96.3%
797,My Generation,546183,0,546183,2018.csv,2018,-,100%
798,"DCI 2019: Big, Loud & Live 16",546060,546060,0,2019.csv,2019,100%,-
799,He's Out There,544674,0,544674,2018.csv,2018,-,100%
800,The Day Shall Come,543993,26972,517021,2019.csv,2019,5%,95%
801,Dragon Ball Z: Bardock - The Father of Goku/Dragon Ball Z: Fusion Reborn,540707,540707,0,2018.csv,2018,100%,-
802,Grateful Dead Meet-Up 2019,537153,537153,0,2019.csv,2019,100%,-
803,CatVideoFest,536566,470923,65643,2019.csv,2019,87.8%,12.2%
804,Karwaan,536525,182009,354516,2018.csv,2018,33.9%,66.1%
805,What They Had,533579,260136,273443,2018.csv,2018,48.8%,51.2%
806,Margaret Atwood: Live in Cinemas,529285,93690,435595,2019.csv,2019,17.7%,82.3%
807,The Audience 2019 Re-release,523432,106529,416903,2019.csv,2019,20.4%,79.6%
808,The Spy Behind Home Plate,519525,519525,0,2019.csv,2019,100%,-
809,Wild Nights with Emily,519487,519487,0,2019.csv,2019,100%,-
810,Grave of the Fireflies,516962,516962,0,2018.csv,2018,100%,-
811,The Sandlot 2018 Re-release,516130,516130,0,2018.csv,2018,100%,-
812,Bullitt 2018 Re-release,511350,511350,0,2018.csv,2018,100%,-
813,Monsters and Men,510967,500101,10866,2018.csv,2018,97.9%,2.1%
814,Bolshoi Ballet: Carmen Suite/Petrushka,510628,207523,303105,2019.csv,2019,40.6%,59.4%
815,Saving Private Ryan 2019 Re-release,508694,508694,0,2019.csv,2019,100%,-
816,Have a Nice Day,504003,79393,424610,2018.csv,2018,15.8%,84.2%
817,Whisper of the Heart 2019 Re-release,498156,498156,0,2019.csv,2019,100%,-
818,Nausica√§ of the Valley of the Wind 2019 Re-release,495770,495770,0,2019.csv,2019,100%,-
819,Monty Python's Life of Brian 2019 Re-release,493822,161507,332315,2019.csv,2019,32.7%,67.3%
820,London Fields,487420,252676,234744,2018.csv,2018,51.8%,48.2%
821,The Russian Five,485049,485049,0,2019.csv,2019,100%,-
822,Lawrence of Arabia 2019 Re-release,482281,482281,0,2019.csv,2019,100%,-
823,Liam Gallagher: As It Was,477009,0,477009,2019.csv,2019,-,100%
824,Matangi/Maya/M.I.A,469489,230808,238681,2018.csv,2018,49.2%,50.8%
825,Hail Satan?,467232,424284,42948,2019.csv,2019,90.8%,9.2%
826,Puffs: Filmed Live Off Broadway,464483,464483,0,2018.csv,2018,100%,-
827,MFKZ,461724,229423,232301,2018.csv,2018,49.7%,50.3%
828,Scotty and the Secret History of Hollywood,461689,461689,0,2018.csv,2018,100%,-
829,Christmas Jars,459462,459462,0,2019.csv,2019,100%,-
830,South Pacific 2018 Re-release,458000,458000,0,2018.csv,2018,100%,-
831,The Gospel According to Andr√©,454550,400713,53837,2018.csv,2018,88.2%,11.8%
832,Leaning Into The Wind,452372,400530,51842,2018.csv,2018,88.5%,11.5%
833,Cruel Intentions 2019 Re-release,445218,445218,0,2019.csv,2019,100%,-
834,Porco Rosso 2018 Re-release,443059,443059,0,2018.csv,2018,100%,-
835,Elf 2018 Re-release,442073,442073,0,2018.csv,2018,100%,-
836,We the Animals,434743,400961,33782,2018.csv,2018,92.2%,7.8%
837,What We Left Behind: Star Trek DS9,434437,382457,51980,2019.csv,2019,88%,12%
838,DCI 2018 Tour Premeire,434008,434008,0,2018.csv,2018,100%,-
839,The Sower,433112,36233,396879,2018.csv,2018,8.4%,91.6%
840,Andy Irons: Kissed by God,430393,285933,144460,2018.csv,2018,66.4%,33.6%
841,Killing Sarai,425332,425332,0,2019.csv,2019,100%,-
842,Cirque du Soleil in Cinema: KURIOS - Cabinet of Curiosities,422760,413039,9721,2018.csv,2018,97.7%,2.3%
843,Ben-Hur 2019 Re-release,422622,422622,0,2019.csv,2019,100%,-
844,The Cold Blue,420177,420177,0,2019.csv,2019,100%,-
845,Frankenstein 2018 Re-release,417783,417783,0,2018.csv,2018,100%,-
846,Happy Phirr Bhag Jayegi,417669,103385,314284,2018.csv,2018,24.8%,75.2%
847,Status Update,416178,4764,411414,2018.csv,2018,1.1%,98.9%
848,The Reliant,408747,408747,0,2019.csv,2019,100%,-
849,Vertigo 2018 Re-release,408560,394212,14348,2018.csv,2018,96.5%,3.5%
850,Please Stand By,406732,9868,396864,2018.csv,2018,2.4%,97.6%
851,The Philadelphia Story 2018 Re-release,404524,404524,0,2018.csv,2018,100%,-
852,The Oath,401463,401463,0,2018.csv,2018,100%,-
853,"Hello, Dolly!",400881,400881,0,2019.csv,2019,100%,-
854,West Side Story 2018 Re-release,398670,398670,0,2018.csv,2018,100%,-
855,Space Mutiny,397887,397887,0,2018.csv,2018,100%,-
856,Krull 2018 Re-release,397157,397157,0,2018.csv,2018,100%,-
857,The Escape,390881,14018,376863,2018.csv,2018,3.6%,96.4%
858,"Westwood: Punk, Icon, Activist",386856,58979,327877,2018.csv,2018,15.2%,84.8%
859,The Wedding Guest,386166,386166,0,2019.csv,2019,100%,-
860,How To Talk To Girls at Parties,385733,84809,300924,2018.csv,2018,22%,78%
861,The Secret World of Arrietty 2019 Re-release,384289,384289,0,2019.csv,2019,100%,-
862,Flower,380553,328188,52365,2018.csv,2018,86.2%,13.8%
863,Jane and Emma,380030,380030,0,2018.csv,2018,100%,-
864,Daughter of Mine,379010,10628,368382,2018.csv,2018,2.8%,97.2%
865,Attack on Titan: Smoke Signal,377334,377334,0,2018.csv,2018,100%,-
866,The Dark Knight 2018 Re-release,375589,375589,0,2018.csv,2018,100%,-
867,The Metropolitan Opera HD Live: Puccini: Turandot,375295,0,375295,2019.csv,2019,-,100%
868,Jurassic Park 2018 Re-release,374238,374238,0,2018.csv,2018,100%,-
869,Pom Poko 2018 Re-release,372405,372405,0,2018.csv,2018,100%,-
870,"Ruben Brandt, Collector 2018 Re-release",369809,117963,251846,2018.csv,2018,31.9%,68.1%
871,Ghostbusters 2019 Re-release,369612,369612,0,2019.csv,2019,100%,-
872,INXS: Baby Live at Wembly Stadium,366425,161750,204675,2019.csv,2019,44.1%,55.9%
873,First Love,366247,218329,147918,2019.csv,2019,59.6%,40.4%
874,Lords of Chaos,365353,253184,112169,2019.csv,2019,69.3%,30.7%
875,Clemency,364716,364716,0,2019.csv,2019,100%,-
876,K-12,359377,303230,56147,2019.csv,2019,84.4%,15.6%
877,The Shawshank Redemption 2019 Re-release,358507,358507,0,2019.csv,2019,100%,-
878,The Tomorrow Man,354103,354103,0,2019.csv,2019,100%,-
879,The Wizard of Oz 2018 Re-release,351839,351839,0,2018.csv,2018,100%,-
880,Bel Canto,350264,125569,224695,2018.csv,2018,35.8%,64.2%
881,Suicide the Ripple Effect,347468,347468,0,2018.csv,2018,100%,-
882,Star Trek 2019 Re-release,346243,346243,0,2019.csv,2019,100%,-
883,Triple Threat,345900,76289,269611,2019.csv,2019,22.1%,77.9%
884,Nureyev: Lifting the Curtain,342255,165203,177052,2018.csv,2018,48.3%,51.7%
885,Knife + Heart,341847,32516,309331,2018.csv,2018,9.5%,90.5%
886,Bolshoi Ballet: Swan Lake,341058,88905,252153,2018.csv,2018,26.1%,73.9%
887,Is It Wrong to Try to Pick Up Girls in a Dungeon - Arrow of the Orion,338632,271489,67143,2019.csv,2019,80.2%,19.8%
888,Silencio,338596,158723,179873,2018.csv,2018,46.9%,53.1%
889,Diane,336166,336166,0,2019.csv,2019,100%,-
890,Sailor Moon R: The Movie: The Promise of the Rose/Sailor Moon S: The Movie - Hearts in Ice,335697,335697,0,2018.csv,2018,100%,-
891,Freaks,335050,276591,58459,2019.csv,2019,82.6%,17.4%
892,Russ Taff: I Still Believe,334983,334983,0,2018.csv,2018,100%,-
893,Anthropocene: The Human Epoch,334162,104806,229356,2019.csv,2019,31.4%,68.6%
894,A Silent Voice: The Movie 2019 Re-release,333984,333984,0,2019.csv,2019,100%,-
895,Shine,333388,333388,0,2018.csv,2018,100%,-
896,The Big Fight Live: IBF Welterweight Title: Errol Spence Jr. vs. Mikey Garcia,328979,328979,0,2019.csv,2019,100%,-
897,Lucy in the Sky,325950,319976,5974,2019.csv,2019,98.2%,1.8%
898,The Opera House,325235,320079,5156,2018.csv,2018,98.4%,1.6%
899,Teefa In Trouble,324633,0,324633,2018.csv,2018,-,100%
900,The Bolshoi Ballet: Live From Moscow - The Nutcracker,323928,323928,0,2018.csv,2018,100%,-
901,The Cured,323776,26630,297146,2018.csv,2018,8.2%,91.8%
902,Sword of Trust,323369,322421,948,2019.csv,2019,99.7%,0.3%
903,Damsel,323235,305136,18099,2018.csv,2018,94.4%,5.6%
904,Woodstock,320610,126562,194048,2019.csv,2019,39.5%,60.5%
905,Cunningham,320293,265102,55191,2019.csv,2019,82.8%,17.2%
906,Meeting Gorbachev,319230,251837,67393,2019.csv,2019,78.9%,21.1%
907,You Are Here: A Come From Away Story,318885,318885,0,2019.csv,2019,100%,-
908,Ask Dr. Ruth,318230,297195,21035,2019.csv,2019,93.4%,6.6%
909,Sauvage / Wild,317536,61604,255932,2018.csv,2018,19.4%,80.6%
910,The Riot and the Dance,316103,316103,0,2018.csv,2018,100%,-
911,Josh Groban Bridges from Madison Square Garden,315173,315173,0,2019.csv,2019,100%,-
912,The Bolshoi Ballet: Live From Moscow - Romeo and Juliet,313088,313088,0,2018.csv,2018,100%,-
913,Bolshoi Ballet: The Sleeping Beauty,311368,311368,0,2019.csv,2019,100%,-
914,Pl√°cido Domingo Gala,311246,52502,258744,2019.csv,2019,16.9%,83.1%
915,MET Opera: Magic Flute,307686,307686,0,2018.csv,2018,100%,-
916,The Mercy 2018 Re-release,306205,29538,276667,2018.csv,2018,9.6%,90.4%
917,The Third Wife,305755,84933,220822,2019.csv,2019,27.8%,72.2%
918,Showtime Championship Boxing: Deontay Wilder vs. Tyson Fury,304482,304482,0,2018.csv,2018,100%,-
919,The Bolshoi Ballet: Live From Moscow - Giselle,302681,302681,0,2018.csv,2018,100%,-
920,Cliffs of Freedom,300842,72476,228366,2019.csv,2019,24.1%,75.9%
921,Sunset Blvd. 2018 Re-release,299645,299645,0,2018.csv,2018,100%,-
922,Harry Potter and the Sorcerer's Stone 2018 Re-release,295917,295917,0,2018.csv,2018,100%,-
923,Shakira in Concert: El Dorado World Tour,294677,271586,23091,2019.csv,2019,92.2%,7.8%
924,Okko's Inn,293385,134787,158598,2018.csv,2018,45.9%,54.1%
925,The Giant Spider Invasion,293053,293053,0,2019.csv,2019,100%,-
926,More Than Funny,290498,290498,0,2018.csv,2018,100%,-
927,Best F(r)iends: Volume 1,290064,252410,37654,2018.csv,2018,87%,13%
928,The Zoya Factor,289631,128831,160800,2019.csv,2019,44.5%,55.5%
929,The Silence of Others,289455,67986,221469,2018.csv,2018,23.5%,76.5%
930,"A White, White Day",288708,0,288708,2019.csv,2019,-,100%
931,Saga of Tanya the Evil - The Movie,288460,288460,0,2019.csv,2019,100%,-
932,Generation Wealth,287709,237709,50000,2018.csv,2018,82.6%,17.4%
933,Skate Kitchen,287307,236799,50508,2018.csv,2018,82.4%,17.6%
934,Time Freak,285416,10003,275413,2018.csv,2018,3.5%,96.5%
935,But Deliver Us from Evil,285169,285169,0,2018.csv,2018,100%,-
936,Khalid: Free Spirit,284229,284229,0,2019.csv,2019,100%,-
937,Disney's Newsies: The Broadway Musical! 2018 Re-release,282429,282429,0,2018.csv,2018,100%,-
938,Mike Wallace Is Here,281245,281245,0,2019.csv,2019,100%,-
939,Octaman,280710,280710,0,2019.csv,2019,100%,-
940,Forrest Gump 2019 Re-release,280266,203088,77178,2019.csv,2019,72.5%,27.5%
941,Namaste England,279934,104156,175778,2018.csv,2018,37.2%,62.8%
942,Wonders of the Sea,279415,100780,178635,2018.csv,2018,36.1%,63.9%
943,Science Fair,277338,276195,1143,2018.csv,2018,99.6%,0.4%
944,See You Soon,277126,0,277126,2019.csv,2019,-,100%
945,True Grit 2019 Re-release,276418,276418,0,2019.csv,2019,100%,-
946,The King,273601,259291,14310,2018.csv,2018,94.8%,5.2%
947,Slayer: The Repentless Killogy,272874,268727,4147,2019.csv,2019,98.5%,1.5%
948,One Child Nation,271841,270128,1713,2019.csv,2019,99.4%,0.6%
949,The World Before Your Feet,268644,268644,0,2018.csv,2018,100%,-
950,Luzia: Cirque du Soleil in Cinema,265673,265673,0,2019.csv,2019,100%,-
951,Out of Liberty,265279,265279,0,2019.csv,2019,100%,-
952,Asbury Park: Riot Redemption Rock 'n Roll,264983,167684,97299,2019.csv,2019,63.3%,36.7%
953,Doctor Who,264629,264629,0,2018.csv,2018,100%,-
954,The Producers 2018 Re-release,263277,216807,46470,2018.csv,2018,82.3%,17.7%
955,The Final Year,262286,191900,70386,2018.csv,2018,73.2%,26.8%
956,Eating You Alive,260534,260534,0,2018.csv,2018,100%,-
957,Her Smell,260481,255599,4882,2019.csv,2019,98.1%,1.9%
958,Star Raiders: The Adventures of Saber Raine,260234,260234,0,2019.csv,2019,100%,-
959,The Cave,258921,62625,196296,2019.csv,2019,24.2%,75.8%
960,Across the Universe 2018 Re-release,258618,258618,0,2018.csv,2018,100%,-
961,Big 2018 Re-release,258507,258507,0,2018.csv,2018,100%,-
962,Helicopter Eela,256952,71971,184981,2018.csv,2018,28%,72%
963,I Got the Hook Up 2,252293,252293,0,2019.csv,2019,100%,-
964,Canal Street,251917,251917,0,2019.csv,2019,100%,-
965,The Twilight Zone: A 60th Anniversary Celebration,248514,248514,0,2019.csv,2019,100%,-
966,Doctor Who: The End of Time: Part One,247798,247798,0,2019.csv,2019,100%,-
967,Hot Summer Nights,246133,0,246133,2018.csv,2018,-,100%
968,Harry Potter and the Chamber of Secrets 2018 Re-release,245501,245501,0,2018.csv,2018,100%,-
969,American Woman,245416,236637,8779,2019.csv,2019,96.4%,3.6%
970,The Fireflies Are Gone,245006,245006,0,2018.csv,2018,100%,-
971,Out of Blue,242847,18779,224068,2019.csv,2019,7.7%,92.3%
972,Play the Flute,241251,241251,0,2019.csv,2019,100%,-
973,Dark River,239182,7714,231468,2018.csv,2018,3.2%,96.8%
974,311 Enlarged to Show Detail 3,238791,238791,0,2019.csv,2019,100%,-
975,RWBY: Argus Limited,238379,238379,0,2018.csv,2018,100%,-
976,Alien Intrusion: Unmasking a Deception,237411,237411,0,2018.csv,2018,100%,-
977,India's Most Wanted,235351,176858,58493,2019.csv,2019,75.1%,24.9%
978,Diamantino,235041,70088,164953,2018.csv,2018,29.8%,70.2%
979,Blind Eyes Opened,234505,234505,0,2020.csv,2020,100%,-
980,Varda by Agn√®s,233809,160765,73044,2019.csv,2019,68.8%,31.2%
981,Superman 2018 Re-release,233585,233585,0,2018.csv,2018,100%,-
982,Premier Boxing Champions: PBC on FOX: Spence vs. Porter,232973,232973,0,2019.csv,2019,100%,-
983,Bish√¥jo senshi Sailor Moon Super S Special,231434,231434,0,2018.csv,2018,100%,-
984,DAZN Boxing: Canelo Alvarez vs. Daniel Jacobs,230703,230703,0,2019.csv,2019,100%,-
985,"Belle and Sebastian, Friends for Life 2018 Re-release",229983,105890,124093,2018.csv,2018,46%,54%
986,Ophelia,229405,50722,178683,2019.csv,2019,22.1%,77.9%
987,Studio 54,227062,199767,27295,2018.csv,2018,88%,12%
988,Mine 9,226421,226421,0,2019.csv,2019,100%,-
989,Millennium Actress 2019 Re-release,225250,225250,0,2019.csv,2019,100%,-
990,Extra Ordinary,223898,164346,59552,2019.csv,2019,73.4%,26.6%
991,Premier Boxing Champions: PBC on FOX PPV: Pacquiao vs. Thurman,223858,223858,0,2019.csv,2019,100%,-
992,BuyBust,223720,178471,45249,2018.csv,2018,79.8%,20.2%
993,Never Surrender: A Galaxy Quest Documentary,222971,222971,0,2019.csv,2019,100%,-
994,Little Pink House,220948,220948,0,2018.csv,2018,100%,-
995,The Metropolitan Opera HD Live: Puccini: Turandot,219619,172627,46992,2018.csv,2018,78.6%,21.4%
996,Fragments of Truth,219342,219342,0,2018.csv,2018,100%,-
997,Harry Potter and the Prisoner of Azkaban 2018 Re-release,218774,218774,0,2018.csv,2018,100%,-
998,Dark Money,217932,217932,0,2018.csv,2018,100%,-
999,Getting Grace,217812,217812,0,2018.csv,2018,100%,-
1000,The Karate Kid 2019 Re-release,215447,215447,0,2019.csv,2019,100%,-
1001,The Treasure of the Sierra Madre,215295,215295,0,2018.csv,2018,100%,-
1002,Hamlet 2019 Re-release,214578,214578,0,2019.csv,2019,100%,-
1003,Tigers Are Not Afraid 2019 Re-release,210138,175559,34579,2019.csv,2019,83.5%,16.5%
1004,"Faith, Hope & Love",210091,210091,0,2019.csv,2019,100%,-
1005,Kathy Griffin: A Hell of a Story,208907,208907,0,2019.csv,2019,100%,-
1006,Agent Mr. Chan,208351,208351,0,2018.csv,2018,100%,-
1007,The Dating Project,208100,208100,0,2018.csv,2018,100%,-
1008,Batman 2019 Re-release,207901,159419,48482,2019.csv,2019,76.7%,23.3%
1009,Heading Home: The Tale of Team Israel,207533,207533,0,2018.csv,2018,100%,-
1010,The Iron Orchard,204881,204881,0,2019.csv,2019,100%,-
1011,Working Woman,204727,64048,140679,2019.csv,2019,31.3%,68.7%
1012,Hesburgh,204709,204709,0,2019.csv,2019,100%,-
1013,Keep the Change,202788,202788,0,2018.csv,2018,100%,-
1014,The Bolshoi Ballet: Live From Moscow - Copp√©lia,202217,202217,0,2018.csv,2018,100%,-
1015,Blink of an Eye,201874,201874,0,2019.csv,2019,100%,-
1016,Zombi Child,200909,25878,175031,2019.csv,2019,12.9%,87.1%
1017,Gemini,200340,200340,0,2018.csv,2018,100%,-
1018,Rebel Without a Cause 2018 Re-release,199963,199963,0,2018.csv,2018,100%,-
1019,Madeline's Madeline,197309,185576,11733,2018.csv,2018,94.1%,5.9%
1020,Have It All -The Movie,197142,197142,0,2018.csv,2018,100%,-
1021,Little Joe,196960,23862,173098,2019.csv,2019,12.1%,87.9%
1022,Bu√±uel in the Labyrinth of the Turtles,196456,36205,160251,2019.csv,2019,18.4%,81.6%
1023,Boom for Real: The Late Teenage Years of Jean-Michel Basquiat,195517,166616,28901,2018.csv,2018,85.2%,14.8%
1024,Family,194601,194601,0,2019.csv,2019,100%,-
1025,Mr. Klein,193028,193028,0,2019.csv,2019,100%,-
1026,Claire's Camera,191980,83418,108562,2018.csv,2018,43.5%,56.5%
1027,The Divine Plan,190031,190031,0,2019.csv,2019,100%,-
1028,Harry Potter and the Goblet of Fire 2018 Re-release,188716,188716,0,2018.csv,2018,100%,-
1029,The Bolshoi Ballet: Live From Moscow - Don Quixote,187946,187946,0,2018.csv,2018,100%,-
1030,Owaranai hito: Miyazaki Hayao,187320,187320,0,2018.csv,2018,100%,-
1031,Twiceland,186078,52874,133204,2018.csv,2018,28.4%,71.6%
1032,National Theatre Live: King Lear,185305,185305,0,2018.csv,2018,100%,-
1033,Cobra Kai Premiere Event feat. The Karate Kid,185082,185082,0,2018.csv,2018,100%,-
1034,To Dust,184495,184495,0,2019.csv,2019,100%,-
1035,The River and the Wall,183602,183602,0,2019.csv,2019,100%,-
1036,Shock and Awe,182415,77980,104435,2018.csv,2018,42.7%,57.3%
1037,Harry Potter and the Deathly Hallows: Part 2 2018 Re-release,181938,181938,0,2018.csv,2018,100%,-
1038,Giant Little Ones,181507,181507,0,2019.csv,2019,100%,-
1039,Rafiki,181316,137968,43348,2019.csv,2019,76.1%,23.9%
1040,Walking on Water,178119,102140,75979,2019.csv,2019,57.3%,42.7%
1041,Modest Heroes,178027,178027,0,2019.csv,2019,100%,-
1042,The Warrior Queen of Jhansi,177289,177289,0,2019.csv,2019,100%,-
1043,"Iyengar: The Man, Yoga, and the Student's Journey",176387,176387,0,2019.csv,2019,100%,-
1044,The Bolshoi Ballet: Live From Moscow - The Flames of Paris,175922,175922,0,2018.csv,2018,100%,-
1045,Always at The Carlyle,174251,174251,0,2018.csv,2018,100%,-
1046,Them That Follow,172952,159218,13734,2019.csv,2019,92.1%,7.9%
1047,Bolshoi Ballet: The Golden Age,171916,171916,0,2019.csv,2019,100%,-
1048,Little Woods,171912,150010,21902,2019.csv,2019,87.3%,12.7%
1049,The Bolshoi Ballet: Live From Moscow - La Sylphide,171177,171177,0,2018.csv,2018,100%,-
1050,Palau the Movie,171155,134696,36459,2019.csv,2019,78.7%,21.3%
1051,Britt-Marie Was Here,168862,36549,132313,2019.csv,2019,21.6%,78.4%
1052,Girls of the Sun,168771,19712,149059,2018.csv,2018,11.7%,88.3%
1053,The Clovehitch Killer,167994,8208,159786,2018.csv,2018,4.9%,95.1%
1054,The Bolshoi Ballet: Live From Moscow - The Lady of the Camellias,167991,167991,0,2018.csv,2018,100%,-
1055,Is Genesis History? 2018 Re-release,166763,166763,0,2018.csv,2018,100%,-
1056,Far From the Tree,166018,166018,0,2018.csv,2018,100%,-
1057,Bright Ones,165627,165627,0,2019.csv,2019,100%,-
1058,The Chambermaid,164531,86422,78109,2019.csv,2019,52.5%,47.5%
1059,Lost & Found,164026,125173,38853,2018.csv,2018,76.3%,23.7%
1060,Halston,163446,151991,11455,2019.csv,2019,93%,7%
1061,The Samuel Project,161565,161565,0,2018.csv,2018,100%,-
1062,Lu Over the Wall,161253,109857,51396,2018.csv,2018,68.1%,31.9%
1063,"Diana Ross: Her Life, Love and Legacy",160968,160968,0,2019.csv,2019,100%,-
1064,National Theatre Live: The Curious Incident of the Dog in the Night-Time 2018 Re-release,160381,160381,0,2018.csv,2018,100%,-
1065,The Last Resort,158646,158646,0,2018.csv,2018,100%,-
1066,Money,155732,155732,0,2019.csv,2019,100%,-
1067,Western,155215,41072,114143,2018.csv,2018,26.5%,73.5%
1068,Bad Reputation,154190,148568,5622,2018.csv,2018,96.4%,3.6%
1069,Eating Animals,153993,149614,4379,2018.csv,2018,97.2%,2.8%
1070,The Tag Along: Devil Fish,153895,20726,133169,2018.csv,2018,13.5%,86.5%
1071,"Buttons, A New Musical Film",151983,151983,0,2018.csv,2018,100%,-
1072,Before You Know It,151507,151507,0,2019.csv,2019,100%,-
1073,Jay Myself,151331,151331,0,2019.csv,2019,100%,-
1074,Glory 2019 Re-release,150801,150801,0,2019.csv,2019,100%,-
1075,Piercing,149211,15856,133355,2019.csv,2019,10.6%,89.4%
1076,The Kingmaker,148611,122587,26024,2019.csv,2019,82.5%,17.5%
1077,Trial by Fire,148504,148504,0,2019.csv,2019,100%,-
1078,War and Peace,148503,148503,0,2019.csv,2019,100%,-
1079,Harry Potter and the Deathly Hallows: Part 1 2018 Re-release,148263,148263,0,2018.csv,2018,100%,-
1080,Night of the Living Dead 2018 Re-release,147423,147423,0,2018.csv,2018,100%,-
1081,Driven,147172,0,147172,2019.csv,2019,-,100%
1082,Hannah,146325,11700,134625,2018.csv,2018,8%,92%
1083,Citizen K,145941,120411,25530,2019.csv,2019,82.5%,17.5%
1084,Framing John DeLorean,145625,145625,0,2019.csv,2019,100%,-
1085,Mr. Smith Goes to Washington 2018 Re-release,144738,144738,0,2018.csv,2018,100%,-
1086,The Price of Everything,144446,87400,57046,2018.csv,2018,60.5%,39.5%
1087,Doctor Who: Logopolis,143248,143248,0,2019.csv,2019,100%,-
1088,Aiyaary,143108,0,143108,2018.csv,2018,-,100%
1089,Best F(r)iends Volume Two,141524,141524,0,2018.csv,2018,100%,-
1090,Branagh Theatre Live: The Winter's Tale,141143,141143,0,2019.csv,2019,100%,-
1091,Canelo vs. Kovalev,140820,140820,0,2019.csv,2019,100%,-
1092,Support the Girls,139550,129124,10426,2018.csv,2018,92.5%,7.5%
1093,Burden,139270,139270,0,2020.csv,2020,100%,-
1094,Wilder vs. Ortiz,139207,139207,0,2019.csv,2019,100%,-
1095,Head Full of Honey,138844,12350,126494,2018.csv,2018,8.9%,91.1%
1096,The Brawler,138515,75929,62586,2018.csv,2018,54.8%,45.2%
1097,Who Will Write Our History,138039,138039,0,2019.csv,2019,100%,-
1098,Lynryd Skynyrd: Last of the Street Survivors Farewell Tour,137888,137888,0,2019.csv,2019,100%,-
1099,Mantra: Sounds Into Silence,135684,115013,20671,2018.csv,2018,84.8%,15.2%
1100,Sonchiriya,135413,86765,48648,2019.csv,2019,64.1%,35.9%
1101,The Other Story,135191,135191,0,2019.csv,2019,100%,-
1102,Another Day of Life,134801,3190,131611,2018.csv,2018,2.4%,97.6%
1103,Made in Abyss: Journey's Dawn,134194,134047,147,2019.csv,2019,99.9%,0.1%
1104,Be Natural: The Untold Story of Alice Guy-Blach√©,133183,115265,17918,2019.csv,2019,86.5%,13.5%
1105,Harry Potter and the Order of the Phoenix 2018 Re-release,132522,132522,0,2018.csv,2018,100%,-
1106,Rudy 2018 Re-release,131200,131200,0,2018.csv,2018,100%,-
1107,The Wind,130974,28252,102722,2019.csv,2019,21.6%,78.4%
1108,Mister America,130897,130897,0,2019.csv,2019,100%,-
1109,The Image Book,130802,94153,36649,2018.csv,2018,72%,28%
1110,Saheb Biwi Aur Gangster 3,130403,0,130403,2018.csv,2018,-,100%
1111,Little Monsters,130381,0,130381,2019.csv,2019,-,100%
1112,Five Seasons: The Gardens of Piet Oudolf,130319,119223,11096,2018.csv,2018,91.5%,8.5%
1113,Harry Potter and the Half-Blood Prince 2018 Re-release,130081,130081,0,2018.csv,2018,100%,-
1114,Section 375,129916,0,129916,2019.csv,2019,-,100%
1115,The Metropolitan Opera HD Live: Puccini: Madama Butterfly,129730,129730,0,2018.csv,2018,100%,-
1116,The Metropolitan Opera HD Live: Tchaikovsky: Eugene Onegin 2018 Re-release,129498,129498,0,2018.csv,2018,100%,-
1117,The Metropolitan Opera HD Live: Verdi: Il Trovatore,129393,129393,0,2018.csv,2018,100%,-
1118,Where Hands Touch,128269,67743,60526,2018.csv,2018,52.8%,47.2%
1119,Sleepless in Seattle 2018 Re-release,127281,127281,0,2018.csv,2018,100%,-
1120,The Great Buster,125807,118344,7463,2018.csv,2018,94.1%,5.9%
1121,Paris Is Burning 2019 Re-release,125677,125677,0,2019.csv,2019,100%,-
1122,This Changes Everything,125348,64988,60360,2019.csv,2019,51.8%,48.2%
1123,Mary Magdalene 2019 Re-release,124741,124741,0,2019.csv,2019,100%,-
1124,Hymn: Sarah Brightman In Concert,124707,113274,11433,2018.csv,2018,90.8%,9.2%
1125,'85: The Greatest Team in Football History,124573,124573,0,2018.csv,2018,100%,-
1126,Wings of Desire 2018 Re-release,123830,123830,0,2018.csv,2018,100%,-
1127,Easy Rider 2019 Re-release,123276,123276,0,2019.csv,2019,100%,-
1128,Blood Fest,122833,82774,40059,2018.csv,2018,67.4%,32.6%
1129,"14 Days, 12 Nights",122806,122530,276,2020.csv,2020,99.8%,0.2%
1130,Tremors,121813,23911,97902,2019.csv,2019,19.6%,80.4%
1131,A Tuba to Cuba,121772,121772,0,2019.csv,2019,100%,-
1132,Yu-Gi-Oh!: The Movie - Pyramid of Light 2018 Re-release,121688,121688,0,2018.csv,2018,100%,-
1133,Love After Love,121098,121098,0,2018.csv,2018,100%,-
1134,Avant qu'on explose,119894,119894,0,2019.csv,2019,100%,-
1135,Styx 2018 Re-release,118188,70794,47394,2018.csv,2018,59.9%,40.1%
1136,Bisbee '17,117470,117470,0,2018.csv,2018,100%,-
1137,George Takei's Allegiance 2018 Re-release,117162,117162,0,2018.csv,2018,100%,-
1138,Skin,116863,0,116863,2019.csv,2019,-,100%
1139,Mob Psycho 100,115766,115766,0,2019.csv,2019,100%,-
1140,Nostalgia,114603,114603,0,2018.csv,2018,100%,-
1141,John McEnroe: In the Realm of Perfection,114289,90964,23325,2018.csv,2018,79.6%,20.4%
1142,Bodied,113956,113956,0,2018.csv,2018,100%,-
1143,The Woman Who Loves Giraffes,113858,113858,0,2019.csv,2019,100%,-
1144,Police Story,113164,113164,0,2019.csv,2019,100%,-
1145,Filmworker,112828,102609,10219,2018.csv,2018,90.9%,9.1%
1146,A Boy. A Girl. A Dream.,112552,112552,0,2018.csv,2018,100%,-
1147,"Hale County This Morning, This Evening",112282,112282,0,2018.csv,2018,100%,-
1148,The Dawn Wall,112191,112191,0,2018.csv,2018,100%,-
1149,A Chance in the World - Premiere,112007,112007,0,2018.csv,2018,100%,-
1150,A Paris Education,111197,21598,89599,2018.csv,2018,19.4%,80.6%
1151,Babylon,109749,109749,0,2019.csv,2019,100%,-
1152,Red Sorghum,108371,0,108371,2018.csv,2018,-,100%
1153,"No Date, No Signature",107368,36444,70924,2018.csv,2018,33.9%,66.1%
1154,National Theatre Live: Julius Caesar,107057,107057,0,2018.csv,2018,100%,-
1155,The Charmer,106379,26167,80212,2018.csv,2018,24.6%,75.4%
1156,The Brink,106057,106057,0,2019.csv,2019,100%,-
1157,Never Heard,105271,105271,0,2018.csv,2018,100%,-
1158,Cold Case Hammarskj√∂ld,104965,104965,0,2019.csv,2019,100%,-
1159,Andrei Rublev 2018 Re-release,102021,102021,0,2018.csv,2018,100%,-
1160,Hotel by the River,101879,28354,73525,2019.csv,2019,27.8%,72.2%
1161,Those Who Remained,101737,0,101737,2019.csv,2019,-,100%
1162,Kickboxer: Retaliation,101690,4537,97153,2018.csv,2018,4.5%,95.5%
1163,First Cow,101068,101068,0,2020.csv,2020,100%,-
1164,QT8: The First Eight,100396,51896,48500,2019.csv,2019,51.7%,48.3%
1165,All About Nina,100335,100335,0,2018.csv,2018,100%,-
1166,Heavy Water,99503,55446,44057,2019.csv,2019,55.7%,44.3%
1167,Meow Wolf: Origin Story,99488,99488,0,2018.csv,2018,100%,-
1168,High Strung Free Dance 2019 Re-release,98481,83891,14590,2019.csv,2019,85.2%,14.8%
1169,Reign of Judges: Title of Liberty - Concept Short,98408,93224,5184,2018.csv,2018,94.7%,5.3%
1170,Charlie Says,98240,40685,57555,2019.csv,2019,41.4%,58.6%
1171,National Theatre Live: Macbeth,97857,97857,0,2018.csv,2018,100%,-
1172,Prassthanam,97204,19984,77220,2019.csv,2019,20.6%,79.4%
1173,Godspeed: The Race Across America,96690,96690,0,2018.csv,2018,100%,-
1174,Saint Judy,96212,78935,17277,2019.csv,2019,82%,18%
1175,A Bigger Splash 2019 Re-release,95826,95826,0,2019.csv,2019,100%,-
1176,The Final Wish,95215,25183,70032,2019.csv,2019,26.4%,73.6%
1177,The Night Eats the World,95208,0,95208,2018.csv,2018,-,100%
1178,Papi Chulo,94321,84703,9618,2019.csv,2019,89.8%,10.2%
1179,Let the Corpses Tan,93409,93409,0,2018.csv,2018,100%,-
1180,Nancy,92000,80115,11885,2018.csv,2018,87.1%,12.9%
1181,Mapplethorpe,91002,91002,0,2019.csv,2019,100%,-
1182,BANDSTAND: The Broadway Musical on Screen 2018 Re-release,91000,91000,0,2018.csv,2018,100%,-
1183,Yuri!!! On Ice,90751,81878,8873,2018.csv,2018,90.2%,9.8%
1184,Loopers: The Caddie's Long Walk,90679,90679,0,2019.csv,2019,100%,-
1185,Minding the Gap,90328,11998,78330,2018.csv,2018,13.3%,86.7%
1186,Running for Grace,89988,89988,0,2018.csv,2018,100%,-
1187,Cat on a Hot Tin Roof,89332,89332,0,2018.csv,2018,100%,-
1188,The Lumber Baron,88336,88336,0,2019.csv,2019,100%,-
1189,Jim Allison: Breakthrough,87984,87984,0,2019.csv,2019,100%,-
1190,Goldstone 2018 Re-release,87639,87639,0,2018.csv,2018,100%,-
1191,ECCO,86858,86858,0,2019.csv,2019,100%,-
1192,Vault,86741,29491,57250,2019.csv,2019,34%,66%
1193,Beuys,86451,65410,21041,2018.csv,2018,75.7%,24.3%
1194,Skid Row Marathon,84997,84997,0,2019.csv,2019,100%,-
1195,Woodstock,84440,84440,0,2019.csv,2019,100%,-
1196,"Nico, 1988",83558,73304,10254,2018.csv,2018,87.7%,12.3%
1197,Doctor Who: The Woman Who Fell to Earth,82698,82698,0,2018.csv,2018,100%,-
1198,Prey,82258,0,82258,2019.csv,2019,-,100%
1199,Bhavesh Joshi Superhero,81792,57376,24416,2018.csv,2018,70.1%,29.9%
1200,Yomeddine,81030,11308,69722,2018.csv,2018,14%,86%
1201,Woman Walks Ahead,80912,57528,23384,2018.csv,2018,71.1%,28.9%
1202,Kind Hearts and Coronets 2019 Re-release,80795,35948,44847,2019.csv,2019,44.5%,55.5%
1203,Batman Returns 2019 Re-release,80699,70642,10057,2019.csv,2019,87.5%,12.5%
1204,Ms. Purple,80657,80657,0,2019.csv,2019,100%,-
1205,Armstrong,80169,19740,60429,2019.csv,2019,24.6%,75.4%
1206,En el s√©ptimo d√≠a,79887,79887,0,2018.csv,2018,100%,-
1207,End of the Century,79607,66309,13298,2019.csv,2019,83.3%,16.7%
1208,Christ Stopped at Eboli,78736,78736,0,2019.csv,2019,100%,-
1209,The Boxcar Children - Surprise Island,78676,78676,0,2018.csv,2018,100%,-
1210,Un traductor,78075,13509,64566,2018.csv,2018,17.3%,82.7%
1211,Parchi,77110,69431,7679,2018.csv,2018,90%,10%
1212,Fast Colour,76916,76916,0,2019.csv,2019,100%,-
1213,93Queen,76056,76056,0,2018.csv,2018,100%,-
1214,Touch Me Not,75507,13782,61725,2018.csv,2018,18.3%,81.7%
1215,The Riot Act,75506,75506,0,2018.csv,2018,100%,-
1216,"Love, Antosha",75308,50168,25140,2019.csv,2019,66.6%,33.4%
1217,Above and Beyond: NASA's Journey to Tomorrow,74711,74711,0,2018.csv,2018,100%,-
1218,The Boy Downstairs,73988,13638,60350,2018.csv,2018,18.4%,81.6%
1219,After Auschwitz,73885,73885,0,2018.csv,2018,100%,-
1220,Primal Rage: The Legend of Konga,73383,21497,51886,2018.csv,2018,29.3%,70.7%
1221,Antonio Lopez 1970: Sex Fashion & Disco,73122,43169,29953,2018.csv,2018,59%,41%
1222,5B,72968,72968,0,2019.csv,2019,100%,-
1223,Greener Grass,71838,51456,20382,2019.csv,2019,71.6%,28.4%
1224,Free Trip to Egypt 2019 Re-release,71087,71087,0,2019.csv,2019,100%,-
1225,The Fog 2018 Re-release,70421,70421,0,2018.csv,2018,100%,-
1226,Wastelander,70045,70045,0,2018.csv,2018,100%,-
1227,Chef Flynn,69542,68407,1135,2018.csv,2018,98.4%,1.6%
1228,Outside In,68492,68492,0,2018.csv,2018,100%,-
1229,Last Year at Marienbad 2019 Re-release,68402,63425,4977,2019.csv,2019,92.7%,7.3%
1230,The Eyes of Orson Welles,68328,10253,58075,2018.csv,2018,15%,85%
1231,10x10,68260,2263,65997,2018.csv,2018,3.3%,96.7%
1232,¬°He matado a mi marido!,68017,45777,22240,2019.csv,2019,67.3%,32.7%
1233,Making the Five Heartbeats,67415,67415,0,2018.csv,2018,100%,-
1234,Being Frank,67343,67343,0,2019.csv,2019,100%,-
1235,The Doctor from India,67136,67136,0,2018.csv,2018,100%,-
1236,"3100, Run and Become",66789,65524,1265,2018.csv,2018,98.1%,1.9%
1237,Searching for Ingmar Bergman,64742,36686,28056,2018.csv,2018,56.7%,43.3%
1238,"Monrovia, Indiana",64596,63944,652,2018.csv,2018,99%,1%
1239,Making Waves: The Art of Cinematic Sound,63998,53144,10854,2019.csv,2019,83%,17%
1240,The Gardener,62734,62734,0,2018.csv,2018,100%,-
1241,The Swan,62716,2367,60349,2018.csv,2018,3.8%,96.2%
1242,River Runs Red,61789,9893,51896,2018.csv,2018,16%,84%
1243,Here and Now,61271,13892,47379,2018.csv,2018,22.7%,77.3%
1244,Never Goin' Back,61271,61271,0,2018.csv,2018,100%,-
1245,The Mountain,61035,61035,0,2019.csv,2019,100%,-
1246,A Kid Like Jake,60784,58403,2381,2018.csv,2018,96.1%,3.9%
1247,Viper Club,60607,60607,0,2018.csv,2018,100%,-
1248,John Fogerty: 50 Year Trip - Live at Red Rocks,59795,59795,0,2019.csv,2019,100%,-
1249,Where Is Kyra?,59717,59717,0,2018.csv,2018,100%,-
1250,Bomb City,59329,59329,0,2018.csv,2018,100%,-
1251,Digimon Adventure tri. Part 4: Loss,59114,59114,0,2018.csv,2018,100%,-
1252,Horn from the Heart: The Paul Butterfield Story,58597,58597,0,2018.csv,2018,100%,-
1253,Cynthia,58177,58177,0,2018.csv,2018,100%,-
1254,In Search of Greatness,58090,58090,0,2018.csv,2018,100%,-
1255,Ramen Heads,57345,57345,0,2018.csv,2018,100%,-
1256,The Disappearance of My Mother,56821,24951,31870,2019.csv,2019,43.9%,56.1%
1257,Notebook,56166,0,56166,2019.csv,2019,-,100%
1258,Mamma Mia! 2018 Re-release,55168,39601,15567,2018.csv,2018,71.8%,28.2%
1259,American Dream: Detroit,55092,55092,0,2018.csv,2018,100%,-
1260,DAZN Boxing: Canelo Alvarez vs. Rocky Fielding,54916,54916,0,2018.csv,2018,100%,-
1261,Digimon Adventure tri. Part 6: Future,54324,54324,0,2018.csv,2018,100%,-
1262,The Assassin's Code,53940,11218,42722,2018.csv,2018,20.8%,79.2%
1263,The Legend of Hallowaiian,53738,451,53287,2018.csv,2018,0.8%,99.2%
1264,Grass,53503,8084,45419,2018.csv,2018,15.1%,84.9%
1265,The Great Silence,53074,53074,0,2018.csv,2018,100%,-
1266,Bigger,52133,46382,5751,2018.csv,2018,89%,11%
1267,The Snowman Trek,51743,51743,0,2018.csv,2018,100%,-
1268,Wanda 2018 Re-release,51713,51713,0,2018.csv,2018,100%,-
1269,Midnight Family,51712,42310,9402,2019.csv,2019,81.8%,18.2%
1270,Clinton Road,50400,50400,0,2019.csv,2019,100%,-
1271,Midnight Traveler,50336,41265,9071,2019.csv,2019,82%,18%
1272,The Royal Wedding: Prince Harry and Meghan Markle,50264,50264,0,2018.csv,2018,100%,-
1273,Free Trip to Egypt,49693,49693,0,2019.csv,2019,100%,-
1274,Jumanji/Jumanji: Welcome to the Jungle 2018 NCM Fathom Event,49381,49381,0,2018.csv,2018,100%,-
1275,Hal,49045,48698,347,2018.csv,2018,99.3%,0.7%
1276,The Bounty Killer,48815,48815,0,2019.csv,2019,100%,-
1277,The China Hustle,48650,48650,0,2018.csv,2018,100%,-
1278,The Queen,47818,47818,0,2019.csv,2019,100%,-
1279,350 Days - Legends. Champions. Survivors,47526,47526,0,2018.csv,2018,100%,-
1280,The Raft,47269,39678,7591,2019.csv,2019,83.9%,16.1%
1281,High on the Hog,45696,45696,0,2019.csv,2019,100%,-
1282,Mercury,45429,0,45429,2018.csv,2018,-,100%
1283,The Proposal,45149,45149,0,2019.csv,2019,100%,-
1284,Celebration,44898,22557,22341,2019.csv,2019,50.2%,49.8%
1285,That Summer,44659,34556,10103,2018.csv,2018,77.4%,22.6%
1286,What Is Democracy?,44536,44536,0,2019.csv,2019,100%,-
1287,Maze 2019 Re-release,44381,44381,0,2019.csv,2019,100%,-
1288,Carmine Street Guitars,44253,44253,0,2019.csv,2019,100%,-
1289,Slut in a Good Way,44240,40513,3727,2019.csv,2019,91.6%,8.4%
1290,Liyana,44045,44045,0,2018.csv,2018,100%,-
1291,Garry Winogrand: All Things are Photographable,44002,44002,0,2018.csv,2018,100%,-
1292,Hitler's Hollywood,43766,43766,0,2018.csv,2018,100%,-
1293,First We Take Brooklyn,42812,42812,0,2018.csv,2018,100%,-
1294,Golden Exits,41888,41888,0,2018.csv,2018,100%,-
1295,Union,41656,41656,0,2019.csv,2019,100%,-
1296,Blue Iguana,41050,0,41050,2018.csv,2018,-,100%
1297,Why Don't You Just Die!,40995,0,40995,2019.csv,2019,-,100%
1298,On Her Shoulders,40145,28288,11857,2018.csv,2018,70.5%,29.5%
1299,Aniara,40124,40124,0,2019.csv,2019,100%,-
1300,Humor Me,40099,40099,0,2018.csv,2018,100%,-
1301,Submission,39985,39985,0,2018.csv,2018,100%,-
1302,An Elephant Sitting Still,39599,32556,7043,2018.csv,2018,82.2%,17.8%
1303,I Do Not Care If We Go Down in History as Barbarians,39171,11307,27864,2018.csv,2018,28.9%,71.1%
1304,Zilla and Zoe,39003,39003,0,2019.csv,2019,100%,-
1305,Shed of the Dead,38901,38901,0,2019.csv,2019,100%,-
1306,Divide and Conquer: The Story of Roger Ailes,38510,38510,0,2018.csv,2018,100%,-
1307,Araby,38399,38399,0,2018.csv,2018,100%,-
1308,Batman Forever 2019 Re-release,38387,38014,373,2019.csv,2019,99%,1%
1309,No Intenso Agora,38223,24955,13268,2018.csv,2018,65.3%,34.7%
1310,Gray Matter,38034,38034,0,2018.csv,2018,100%,-
1311,The Heart of Nuba,37788,37788,0,2018.csv,2018,100%,-
1312,Krystal,37516,37516,0,2018.csv,2018,100%,-
1313,Memory: The Origins of Alien,37272,31378,5894,2019.csv,2019,84.2%,15.8%
1314,What You Gonna Do When the World's on Fire?,37195,4672,32523,2019.csv,2019,12.6%,87.4%
1315,Small Group,37058,37058,0,2018.csv,2018,100%,-
1316,24 Frames,37045,34482,2563,2018.csv,2018,93.1%,6.9%
1317,The Quiet One,37010,37010,0,2019.csv,2019,100%,-
1318,The Death of Dick Long,36856,36856,0,2019.csv,2019,100%,-
1319,Mind Game,36613,36613,0,2018.csv,2018,100%,-
1320,For Those Who Don't Read Me,36506,36506,0,2018.csv,2018,100%,-
1321,Our Time,36240,14777,21463,2019.csv,2019,40.8%,59.2%
1322,Le Corbeau,36089,36089,0,2018.csv,2018,100%,-
1323,The House of Tomorrow,35821,35821,0,2018.csv,2018,100%,-
1324,The Road Movie,35757,35757,0,2018.csv,2018,100%,-
1325,Good Manners,35714,31177,4537,2018.csv,2018,87.3%,12.7%
1326,Loro,35613,35613,0,2019.csv,2019,100%,-
1327,PGS: Intuition Is Your Personal Guidance System,35423,35423,0,2018.csv,2018,100%,-
1328,√Åga,35178,35178,0,2019.csv,2019,100%,-
1329,Holy Hell,34366,34366,0,2018.csv,2018,100%,-
1330,Maui,33953,33953,0,2018.csv,2018,100%,-
1331,Killer Unicorn,33901,33901,0,2019.csv,2019,100%,-
1332,Moonlight Sonata: Deafness in Three Movements,33823,33823,0,2019.csv,2019,100%,-
1333,"Distant Voices, Still Lives 2018 Re-release",33301,5234,28067,2018.csv,2018,15.7%,84.3%
1334,The Nun,32659,30245,2414,2018.csv,2018,92.6%,7.4%
1335,Sollers Point,32608,32608,0,2018.csv,2018,100%,-
1336,An Acceptable Loss,32427,32427,0,2019.csv,2019,100%,-
1337,10E,32413,32413,0,2019.csv,2019,100%,-
1338,Goodland,32140,32140,0,2018.csv,2018,100%,-
1339,Shooting the Mafia,32042,10881,21161,2019.csv,2019,34%,66%
1340,Desolation Center,32016,32016,0,2019.csv,2019,100%,-
1341,Moynihan,31970,31970,0,2018.csv,2018,100%,-
1342,Gift,31588,31588,0,2019.csv,2019,100%,-
1343,The Cat Rescuers,31540,31540,0,2019.csv,2019,100%,-
1344,Buddy,31203,31203,0,2019.csv,2019,100%,-
1345,Poor Boy,31031,31031,0,2018.csv,2018,100%,-
1346,Pasolini 2019 Re-release,30757,30757,0,2019.csv,2019,100%,-
1347,Los Reyes,30418,30418,0,2019.csv,2019,100%,-
1348,Cold Water,30209,30209,0,2018.csv,2018,100%,-
1349,Lionel Richie at Glastonbury,30123,30123,0,2019.csv,2019,100%,-
1350,Memories of Underdevelopment 2018 Re-release,29647,29647,0,2018.csv,2018,100%,-
1351,The Perfect Race,29644,29644,0,2019.csv,2019,100%,-
1352,Charm City,29335,29335,0,2018.csv,2018,100%,-
1353,The Ground Beneath My Feet,29251,29251,0,2019.csv,2019,100%,-
1354,Batman & Robin 2019 Re-release,28793,28597,196,2019.csv,2019,99.3%,0.7%
1355,Restoring Tomorrow,28556,28556,0,2018.csv,2018,100%,-
1356,The Load,28410,28410,0,2019.csv,2019,100%,-
1357,Quai des Orf√®vres 2018 Re-release,28013,28013,0,2018.csv,2018,100%,-
1358,The Amendment,27961,27961,0,2018.csv,2018,100%,-
1359,El Norte 2019 Re-release,27920,27920,0,2019.csv,2019,100%,-
1360,Bauhaus Spirit: 100 Years of Bauhaus,27768,17122,10646,2019.csv,2019,61.7%,38.3%
1361,Senso,27723,27723,0,2018.csv,2018,100%,-
1362,An Evening with Beverly Luff Linn,27359,6701,20658,2018.csv,2018,24.5%,75.5%
1363,"Leaving Home, Coming Home: A Portrait of Robert Frank",27073,27073,0,2019.csv,2019,100%,-
1364,Wrestle,26597,26597,0,2019.csv,2019,100%,-
1365,Milford Graves Full Mantis,26566,26566,0,2018.csv,2018,100%,-
1366,Rosie,26441,6839,19602,2019.csv,2019,25.9%,74.1%
1367,At First Light,26338,3292,23046,2018.csv,2018,12.5%,87.5%
1368,Marlina the Murderer in Four Acts,26331,17788,8543,2018.csv,2018,67.6%,32.4%
1369,Donnybrook,26284,26284,0,2019.csv,2019,100%,-
1370,The Misandrists,26123,26123,0,2018.csv,2018,100%,-
1371,Ridge Runners,26019,26019,0,2018.csv,2018,100%,-
1372,Jet Trash 2018 Re-release,26002,26002,0,2018.csv,2018,100%,-
1373,Black Mother,25919,18762,7157,2018.csv,2018,72.4%,27.6%
1374,Vazante,25091,23884,1207,2018.csv,2018,95.2%,4.8%
1375,An Elephant's Journey,24844,24844,0,2018.csv,2018,100%,-
1376,Hy√®nes,24672,24672,0,2019.csv,2019,100%,-
1377,The Aspern Papers,24554,9277,15277,2019.csv,2019,37.8%,62.2%
1378,Too Late to Die Young,24487,16591,7896,2018.csv,2018,67.8%,32.2%
1379,Chasing Einstein,24057,24057,0,2019.csv,2019,100%,-
1380,Under The Wire,23897,3429,20468,2018.csv,2018,14.3%,85.7%
1381,Death House,23833,23833,0,2018.csv,2018,100%,-
1382,Letter from Masanjia,23481,23481,0,2018.csv,2018,100%,-
1383,Robert the Bruce,23425,0,23425,2019.csv,2019,-,100%
1384,The Judge,23127,22257,870,2018.csv,2018,96.2%,3.8%
1385,Three Peaks,23069,16216,6853,2018.csv,2018,70.3%,29.7%
1386,Ode to Joy,22594,17303,5291,2019.csv,2019,76.6%,23.4%
1387,Heavy Trip,22460,10153,12307,2018.csv,2018,45.2%,54.8%
1388,The Atomic Cafe,22293,22293,0,2018.csv,2018,100%,-
1389,Winning Formula,22189,22189,0,2018.csv,2018,100%,-
1390,The Sound of Silence,21994,20013,1981,2019.csv,2019,91%,9%
1391,The Female Brain,21786,21786,0,2018.csv,2018,100%,-
1392,Wicked Witches,21600,21600,0,2019.csv,2019,100%,-
1393,Half the Picture,21589,21589,0,2018.csv,2018,100%,-
1394,Hagazussa,21487,13253,8234,2018.csv,2018,61.7%,38.3%
1395,Tyrel,21456,21456,0,2018.csv,2018,100%,-
1396,Ganja & Hess,21197,21197,0,2018.csv,2018,100%,-
1397,The Happys,21108,21108,0,2018.csv,2018,100%,-
1398,Round of Your Life,20941,20941,0,2019.csv,2019,100%,-
1399,Ava,20940,20940,0,2018.csv,2018,100%,-
1400,Did You Wonder Who Fired the Gun?,20765,20765,0,2018.csv,2018,100%,-
1401,Freak Show,20657,19696,961,2018.csv,2018,95.3%,4.7%
1402,Ice Dragon: Legend of the Blue Daisies,20549,20549,0,2018.csv,2018,100%,-
1403,The Devil and Father Amorth,20449,20449,0,2018.csv,2018,100%,-
1404,Izzy Gets the F*ck Across Town,20208,20208,0,2018.csv,2018,100%,-
1405,Apocalypsis,20052,20052,0,2018.csv,2018,100%,-
1406,General Magic,20046,20046,0,2019.csv,2019,100%,-
1407,The Gospel of Eureka,20039,20039,0,2019.csv,2019,100%,-
1408,Eight Hours Don't Make a Day,19987,19987,0,2018.csv,2018,100%,-
1409,"One Sings, the Other Doesn't",19919,19919,0,2018.csv,2018,100%,-
1410,Active Measures,19862,19862,0,2018.csv,2018,100%,-
1411,Damascus Cover,19532,0,19532,2018.csv,2018,-,100%
1412,Who We Are Now,19128,19128,0,2018.csv,2018,100%,-
1413,November,19084,19084,0,2018.csv,2018,100%,-
1414,Anything,19037,19037,0,2018.csv,2018,100%,-
1415,Frank and Ava,18829,18829,0,2018.csv,2018,100%,-
1416,Scandalous: The True Story of the National Enquirer,18759,18759,0,2019.csv,2019,100%,-
1417,Before Stonewall,18724,18724,0,2019.csv,2019,100%,-
1418,Crime + Punishment,18644,18644,0,2018.csv,2018,100%,-
1419,The Return of Martin Guerre 2019 Re-release,18603,18603,0,2019.csv,2019,100%,-
1420,The Pagan King: The Battle of Death,18598,0,18598,2018.csv,2018,-,100%
1421,Allegiance to Broadway,18527,18527,0,2018.csv,2018,100%,-
1422,Desolation,18490,18490,0,2018.csv,2018,100%,-
1423,306 Hollywood,18399,18399,0,2018.csv,2018,100%,-
1424,"Phoenix, Oregon",18356,18356,0,2019.csv,2019,100%,-
1425,King of Hearts,18130,17646,484,2018.csv,2018,97.3%,2.7%
1426,The Cranes Are Flying,17923,17923,0,2019.csv,2019,100%,-
1427,Batman: Mask of the Phantasm 2018 Re-release,17813,17813,0,2018.csv,2018,100%,-
1428,The Chronicle of Anna Magdalena Bach,17527,17527,0,2018.csv,2018,100%,-
1429,Chained for Life,17431,17431,0,2019.csv,2019,100%,-
1430,"A Bread Factory, Part One/A Bread Factory, Part Two",17325,17325,0,2018.csv,2018,100%,-
1431,Revival,17252,17252,0,2018.csv,2018,100%,-
1432,Joseph Pulitzer: Voice of the People,16970,16970,0,2019.csv,2019,100%,-
1433,Haikara-San: Here Comes Miss Modern,16572,16572,0,2018.csv,2018,100%,-
1434,Detour,16172,16172,0,2018.csv,2018,100%,-
1435,Virginia Minnesota,16118,16118,0,2019.csv,2019,100%,-
1436,Starfish,15849,15849,0,2019.csv,2019,100%,-
1437,Trinity Seven The Movie 2: Heavens Library & Crimson Lord,15712,15712,0,2019.csv,2019,100%,-
1438,Out on Stage,15623,15623,0,2018.csv,2018,100%,-
1439,The Competition 2019 Re-release,15622,15622,0,2019.csv,2019,100%,-
1440,Bob le Flambeur,15586,15586,0,2018.csv,2018,100%,-
1441,When You Read This Letter,15552,15552,0,2018.csv,2018,100%,-
1442,Postcards from London,15548,5312,10236,2018.csv,2018,34.2%,65.8%
1443,Stuffed,15532,15532,0,2019.csv,2019,100%,-
1444,Tom of Finland 2018 Re-release,15483,3314,12169,2018.csv,2018,21.4%,78.6%
1445,Between the Lines,15383,15383,0,2019.csv,2019,100%,-
1446,Narcissister Organ Player,15334,15334,0,2018.csv,2018,100%,-
1447,People's Republic of Desire,15241,15241,0,2018.csv,2018,100%,-
1448,Funan,15152,15152,0,2019.csv,2019,100%,-
1449,Wrinkles the Clown,14938,14938,0,2019.csv,2019,100%,-
1450,Trust Machine: The Story of Blockchain,14905,14905,0,2018.csv,2018,100%,-
1451,ZZ Top: That Little Ol' Band from Texas,14879,14879,0,2019.csv,2019,100%,-
1452,Ferrante Fever,14518,11137,3381,2018.csv,2018,76.7%,23.3%
1453,The Public Image is Rotten,14464,11293,3171,2018.csv,2018,78.1%,21.9%
1454,My Son 2019 Re-release,14450,14450,0,2019.csv,2019,100%,-
1455,The Last Movie Star,14410,14410,0,2018.csv,2018,100%,-
1456,Combat Obscura,14242,14242,0,2019.csv,2019,100%,-
1457,Chasing the Blues,14030,14030,0,2018.csv,2018,100%,-
1458,Screwball,13967,13967,0,2019.csv,2019,100%,-
1459,Weed the People,13926,13926,0,2018.csv,2018,100%,-
1460,Genesis,13856,6784,7072,2019.csv,2019,49%,51%
1461,Stavisky...,13793,13793,0,2018.csv,2018,100%,-
1462,This One's for the Ladies,13688,13688,0,2019.csv,2019,100%,-
1463,Rapid Response,13294,13294,0,2019.csv,2019,100%,-
1464,Our Blood is Wine,13210,13210,0,2018.csv,2018,100%,-
1465,Like Me,12965,12965,0,2018.csv,2018,100%,-
1466,Kangaroo,12626,4547,8079,2018.csv,2018,36%,64%
1467,American Socialist: The Life and Times of Eugene Victor Debs,12609,12609,0,2018.csv,2018,100%,-
1468,Of Fathers and Sons,12579,12579,0,2018.csv,2018,100%,-
1469,My Art,12554,12554,0,2018.csv,2018,100%,-
1470,Off Season,12544,12544,0,2019.csv,2019,100%,-
1471,American Chaos,12368,12368,0,2018.csv,2018,100%,-
1472,L'h√©ritage de la chouette,12316,12316,0,2018.csv,2018,100%,-
1473,Bricked,12201,12201,0,2019.csv,2019,100%,-
1474,The Most Unknown,12119,12119,0,2018.csv,2018,100%,-
1475,Zen for Nothing,12107,12107,0,2019.csv,2019,100%,-
1476,Imprisoned,12050,12050,0,2019.csv,2019,100%,-
1477,Quartet,12042,12042,0,2019.csv,2019,100%,-
1478,The Last Race,11947,11947,0,2018.csv,2018,100%,-
1479,"Cassandro, The Exotico!",11897,11897,0,2019.csv,2019,100%,-
1480,Les Parents Terribles,11818,11818,0,2018.csv,2018,100%,-
1481,Summer '03,11746,11746,0,2018.csv,2018,100%,-
1482,Around India with a Movie Camera,11568,10389,1179,2018.csv,2018,89.8%,10.2%
1483,Rendezvous in July,11321,11321,0,2018.csv,2018,100%,-
1484,Bullitt County,11257,11257,0,2018.csv,2018,100%,-
1485,In Like Flynn,11255,11255,0,2019.csv,2019,100%,-
1486,Made Me Do It,11151,11151,0,2019.csv,2019,100%,-
1487,Edward II 2018 Re-release,11055,4826,6229,2018.csv,2018,43.7%,56.3%
1488,Suburban Birds,10997,10997,0,2019.csv,2019,100%,-
1489,If the Dancer Dances,10912,10912,0,2019.csv,2019,100%,-
1490,Vision Portraits,10771,10771,0,2019.csv,2019,100%,-
1491,Class Rank,10452,10452,0,2018.csv,2018,100%,-
1492,Mama Africa 2018 Re-release,10430,10430,0,2018.csv,2018,100%,-
1493,The Advocates,10402,10402,0,2018.csv,2018,100%,-
1494,When Lambs Become Lions,10197,9337,860,2019.csv,2019,91.6%,8.4%
1495,Olivia,9934,9934,0,2019.csv,2019,100%,-
1496,Streetwise,9904,9904,0,2019.csv,2019,100%,-
1497,The Quest of Alain Ducasse,9627,9627,0,2018.csv,2018,100%,-
1498,The Spanish Prisoner 2019 Re-release,9589,9589,0,2019.csv,2019,100%,-
1499,Strangers on the Earth,9518,9518,0,2018.csv,2018,100%,-
1500,Fritz Lang's Indian Epic 2019 re-release,9345,9345,0,2019.csv,2019,100%,-
1501,A Dark Place,9212,0,9212,2019.csv,2019,-,100%
1502,Cracked Up,9197,9197,0,2019.csv,2019,100%,-
1503,El Mar La Mar,9065,9065,0,2018.csv,2018,100%,-
1504,Frantz Fanon: Black Skin White Mask,9025,9025,0,2019.csv,2019,100%,-
1505,Step Up: High Water,9005,9005,0,2018.csv,2018,100%,-
1506,Zoo Wars,8998,8998,0,2018.csv,2018,100%,-
1507,Survivors Guide To Prison,8982,8982,0,2018.csv,2018,100%,-
1508,Colossal Youth,8968,8331,637,2018.csv,2018,92.9%,7.1%
1509,Summer of '67,8941,8941,0,2018.csv,2018,100%,-
1510,This is Congo,8905,7051,1854,2018.csv,2018,79.2%,20.8%
1511,The Meanest Man in Texas,8850,8850,0,2019.csv,2019,100%,-
1512,That Part Feeling - the Universe of Arvo Part,8812,8812,0,2019.csv,2019,100%,-
1513,Blood Feast,8708,8708,0,2018.csv,2018,100%,-
1514,Furlough,8472,8472,0,2018.csv,2018,100%,-
1515,The Dead Center,8320,8320,0,2019.csv,2019,100%,-
1516,Spiral,8190,8190,0,2018.csv,2018,100%,-
1517,Angels Are Made Of Light,7919,7919,0,2019.csv,2019,100%,-
1518,This Magnificent Cake!,7888,7888,0,2019.csv,2019,100%,-
1519,Ghost Fleet,7850,7850,0,2019.csv,2019,100%,-
1520,The Plagiarists,7768,7768,0,2019.csv,2019,100%,-
1521,Gregory's Girl,7710,7710,0,2019.csv,2019,100%,-
1522,I'll Take Your Dead,7692,7692,0,2019.csv,2019,100%,-
1523,Legend of the Mountain,7640,7640,0,2018.csv,2018,100%,-
1524,Shoah: Four Sisters,7323,7323,0,2018.csv,2018,100%,-
1525,Beloved Beast,7301,7301,0,2019.csv,2019,100%,-
1526,Tall: The American Skyscraper and Louis Sullivan,7216,7216,0,2018.csv,2018,100%,-
1527,Painless,7082,7082,0,2018.csv,2018,100%,-
1528,In Echo Park,7072,7072,0,2018.csv,2018,100%,-
1529,In the Land of Pomegranates,7014,7014,0,2018.csv,2018,100%,-
1530,Duck Butter,6877,6877,0,2018.csv,2018,100%,-
1531,Calling All Earthlings,6756,6756,0,2018.csv,2018,100%,-
1532,Dying to Survive 2019 Re-release,6752,6752,0,2019.csv,2019,100%,-
1533,A Whale of a Tale,6747,6747,0,2018.csv,2018,100%,-
1534,Iceman,6719,2138,4581,2018.csv,2018,31.8%,68.2%
1535,Under the Eiffel Tower,6291,6291,0,2019.csv,2019,100%,-
1536,One Last Thing,6232,6232,0,2018.csv,2018,100%,-
1537,Relaxer,6133,6133,0,2019.csv,2019,100%,-
1538,I Am MLK Jr.,5918,5918,0,2018.csv,2018,100%,-
1539,An Actor Prepares,5891,1743,4148,2018.csv,2018,29.6%,70.4%
1540,S√©rie noire,5633,5633,0,2019.csv,2019,100%,-
1541,The Miracle of the Little Prince,5553,5553,0,2019.csv,2019,100%,-
1542,Are We Not Cats,5518,5518,0,2018.csv,2018,100%,-
1543,Cuban Food Stories,5434,5434,0,2018.csv,2018,100%,-
1544,In Searching,5210,5210,0,2018.csv,2018,100%,-
1545,Chokehold,5200,5200,0,2019.csv,2019,100%,-
1546,The Gliksmans,5166,5166,0,2019.csv,2019,100%,-
1547,100 Acres of Hell,5152,5152,0,2019.csv,2019,100%,-
1548,Body at Brighton Rock,5123,5123,0,2019.csv,2019,100%,-
1549,Intersection,5116,5116,0,2018.csv,2018,100%,-
1550,Notes on an Appearance,5065,5065,0,2018.csv,2018,100%,-
1551,Chulas Fronteras,5021,5021,0,2019.csv,2019,100%,-
1552,The Texture of Falling,5010,5010,0,2018.csv,2018,100%,-
1553,Social Animals,5007,5007,0,2018.csv,2018,100%,-
1554,The Garden,5006,5006,0,2019.csv,2019,100%,-
1555,An L.A. Minute,5004,5004,0,2018.csv,2018,100%,-
1556,Malek,4898,4898,0,2019.csv,2019,100%,-
1557,The Other Side of Everything,4685,4685,0,2018.csv,2018,100%,-
1558,The Long Dumb Road,4667,4667,0,2018.csv,2018,100%,-
1559,I'm Leaving Now,4488,4488,0,2019.csv,2019,100%,-
1560,Weightless,4461,4461,0,2018.csv,2018,100%,-
1561,SGT. Will Gardner,4405,4405,0,2019.csv,2019,100%,-
1562,The Peacemaker,4400,4400,0,2018.csv,2018,100%,-
1563,The Party's Just Beginning,4371,4145,226,2018.csv,2018,94.8%,5.2%
1564,Tito and the Birds,4332,4332,0,2019.csv,2019,100%,-
1565,The Fate of Lee Khan,4295,4295,0,2019.csv,2019,100%,-
1566,State Like Sleep,4282,4282,0,2019.csv,2019,100%,-
1567,Cocote,4224,3815,409,2018.csv,2018,90.3%,9.7%
1568,Stella's Last Weekend,4215,4215,0,2018.csv,2018,100%,-
1569,Run,4052,0,4052,2020.csv,2020,-,100%
1570,La Flor,4032,4032,0,2019.csv,2019,100%,-
1571,Armed,3948,3948,0,2018.csv,2018,100%,-
1572,Mother of a Day,3919,3919,0,2019.csv,2019,100%,-
1573,American Dresser,3895,3895,0,2018.csv,2018,100%,-
1574,The Second Time Around,3837,3837,0,2018.csv,2018,100%,-
1575,Wallflower,3801,3801,0,2019.csv,2019,100%,-
1576,Nelly,3751,3751,0,2018.csv,2018,100%,-
1577,The Family,3696,3696,0,2018.csv,2018,100%,-
1578,The Wandering Soap Opera,3624,3624,0,2019.csv,2019,100%,-
1579,Fourplay,3550,3550,0,2018.csv,2018,100%,-
1580,The Citizen 2018 Re-release,3495,3495,0,2018.csv,2018,100%,-
1581,The Cage Fighter,3392,3392,0,2018.csv,2018,100%,-
1582,Rottentail,3383,3383,0,2019.csv,2019,100%,-
1583,Followers,3350,3350,0,2018.csv,2018,100%,-
1584,Over the Limit,3243,3243,0,2018.csv,2018,100%,-
1585,Game Changers,3142,3142,0,2018.csv,2018,100%,-
1586,Hot to Trot,3133,3133,0,2018.csv,2018,100%,-
1587,Chasing Portraits,3076,3076,0,2019.csv,2019,100%,-
1588,Nana,2784,2784,0,2018.csv,2018,100%,-
1589,Back to the Fatherland,2697,2697,0,2019.csv,2019,100%,-
1590,Straight Into a Storm,2684,2684,0,2018.csv,2018,100%,-
1591,ACORN and the Firestorm,2621,2621,0,2018.csv,2018,100%,-
1592,Joan the Maid 1: The Battles,2562,2562,0,2019.csv,2019,100%,-
1593,TINY: The Life of Erin Blackwell,2465,2465,0,2019.csv,2019,100%,-
1594,I Lost Albert 2019 Re-release,2354,2354,0,2019.csv,2019,100%,-
1595,A German Youth,2343,2343,0,2019.csv,2019,100%,-
1596,Serendipity,2298,2298,0,2019.csv,2019,100%,-
1597,Jihadists,2104,2104,0,2019.csv,2019,100%,-
1598,West Of The Jordan River,1926,1926,0,2018.csv,2018,100%,-
1599,Finding Happiness,1841,1841,0,2018.csv,2018,100%,-
1600,Jimi Hendrix Electric Church,1818,0,1818,2019.csv,2019,-,100%
1601,The Lost Village,1780,1780,0,2018.csv,2018,100%,-
1602,Game Day,1624,1624,0,2019.csv,2019,100%,-
1603,Henchmen,1469,1469,0,2018.csv,2018,100%,-
1604,That Way Madness Lies...,1447,1447,0,2018.csv,2018,100%,-
1605,Beauty and the Beholder,1368,1368,0,2018.csv,2018,100%,-
1606,The Hours and Times,1273,1273,0,2019.csv,2019,100%,-
1607,Altered Perception,1259,1259,0,2018.csv,2018,100%,-
1608,Two Men Went to War 2018 Re-release,1227,1227,0,2018.csv,2018,100%,-
1609,Under the Turban,1190,1190,0,2018.csv,2018,100%,-
1610,Half Brothers,1100,1100,0,2018.csv,2018,100%,-
1611,Invisible Hands,1034,1034,0,2018.csv,2018,100%,-
1612,TVTV: Video Revolutionaries,812,812,0,2018.csv,2018,100%,-
1613,The Untold Story,790,790,0,2019.csv,2019,100%,-
1614,The Portal,685,0,685,2019.csv,2019,-,100%
1615,Higher Power,528,528,0,2018.csv,2018,100%,-
1616,A Quiet Place Part II,163,0,163,2020.csv,2020,-,100%
